Year,"Country of origin","Country of asylum","Female 0 - 4","Female 5 - 11","Female 12 - 17","Female 18 - 59","Female 60","Female other","Female total","Male 0 - 4","Male 5 - 11","Male 12 - 17","Male 18 - 59","Male 60","Male other","Male total",Total
2013,Afghanistan,-,125285,295728,215949,588692,35414,2046,1263114,130422,305667,242801,628335,63412,5505,1376142,3538870
2013,Albania,-,87,102,114,1072,105,1070,2550,105,128,147,1350,108,1245,3083,20888
2013,Algeria,-,34,42,42,363,0,599,1080,34,43,95,1909,16,877,2974,7939
2013,Andorra,-,0,0,0,0,0,0,0,0,0,0,0,0,0,0,5
2013,Angola,-,5312,10486,7029,24475,3762,1433,52497,5637,10886,7673,21216,3382,2017,50811,108502
2013,"Antigua and Barbuda",-,0,5,7,13,0,0,25,0,0,5,10,0,0,15,78
2013,Egypt,-,152,221,132,718,108,151,1482,181,215,265,1944,70,376,3051,22282
2013,Argentina,-,0,0,6,11,0,0,17,0,13,0,16,5,5,39,452
2013,Armenia,-,91,130,122,1073,173,2045,3634,122,194,149,1206,121,2004,3796,17369
2013,Australia,-,0,5,0,5,0,0,10,0,5,6,0,0,0,11,32
2013,Austria,-,0,0,0,5,0,0,5,0,0,0,0,0,0,0,15
2013,Azerbaijan,-,145,187,137,1878,479,1485,4311,149,236,167,1985,304,1345,4186,623450
2013,Bahrain,-,8,10,0,14,0,0,32,0,0,6,16,0,0,22,370
2013,Barbados,-,0,0,5,14,0,0,19,0,0,0,34,0,0,34,114
2013,Burundi,-,21636,36266,27626,65946,5624,362,157460,20995,35795,26861,68839,6995,429,159914,328236
2013,Belgium,-,0,5,13,0,0,0,18,0,0,0,0,0,0,0,107
2013,Benin,-,8,14,14,34,0,23,93,5,10,11,239,0,23,288,795
2013,Bangladesh,-,20,30,10,204,10,409,683,31,34,83,3168,12,3047,6375,32582
2013,Bahamas,-,0,0,6,5,0,0,11,0,5,0,13,0,0,18,235
2013,Bhutan,-,1487,1897,1701,8750,1126,15,14976,1474,1999,1900,9308,1431,87,16199,31713
2013,"Burkina Faso",-,10,0,0,50,0,72,132,0,5,19,329,0,74,427,2515
2013,Belarus,-,5,15,10,129,6,252,417,10,12,37,215,15,329,618,5257
2013,"Bolivia (Plurinational State of)",-,5,8,20,49,0,20,102,0,6,7,99,15,20,147,795
2013,Botswana,-,0,0,13,49,0,0,62,0,12,0,18,0,0,30,266
2013,Brazil,-,5,15,5,28,0,8,61,15,19,15,34,0,5,88,1533
2013,"Bosnia and Herzegovina",-,260,490,656,6808,3874,70278,82366,281,533,799,7243,2461,73185,84502,170661
2013,Bulgaria,-,0,10,18,59,16,40,143,0,10,0,97,43,54,204,2052
2013,Belize,-,0,0,0,0,0,0,0,0,0,0,0,0,0,0,90
2013,Cambodia,-,5,14,12,109,10,6459,6609,0,14,11,128,10,6489,6652,13969
2013,Canada,-,0,9,5,5,0,0,19,0,5,11,5,0,0,21,123
2013,"Central African Rep.",-,21001,30921,21501,52650,3518,305,129896,20903,30589,22126,40512,3408,372,117910,1154734
2013,"Cayman Islands",-,0,0,0,0,0,0,0,0,0,0,0,0,0,0,6
2013,Chad,-,327,612,449,1490,78,3674,6630,352,536,506,2870,159,4219,8642,72253
2013,China,-,181,280,233,3184,100,1331,5309,182,257,215,4211,114,2186,7165,219920
2013,Chile,-,0,5,0,60,59,54,178,0,0,5,80,73,51,209,654
2013,Cameroon,-,76,153,105,908,35,422,1699,77,108,132,1627,14,797,2755,15625
2013,Congo,-,87,161,169,723,10,1743,2893,83,158,166,1156,46,1748,3357,15017
2013,"Dem. Rep. of the Congo",-,458929,438378,212733,731990,42917,6906,1891853,441012,430421,185886,462494,30311,7824,1557948,3528790
2013,Comoros,-,0,0,5,7,0,152,164,0,0,0,26,0,322,348,827
2013,Colombia,-,692,2630,2997,16334,821,2741711,2765185,758,2845,3320,18763,1143,2631402,2658231,5780487
2013,"Costa Rica",-,0,5,0,5,0,0,10,5,0,5,8,0,0,18,923
2013,Cuba,-,19,57,245,887,77,57,1342,25,81,106,1706,130,110,2158,8573
2013,"Cabo Verde",-,0,0,0,0,0,0,0,0,0,0,7,0,0,7,39
2013,Cyprus,-,0,0,0,5,0,0,5,0,0,0,0,0,0,0,10
2013,Czechia,-,5,11,21,152,89,20,298,6,8,30,226,183,17,470,1095
2013,Denmark,-,0,0,0,0,0,0,0,0,0,0,0,0,0,0,11
2013,Djibouti,-,12,12,18,83,5,119,249,15,34,16,79,0,111,255,1138
2013,Dominica,-,0,0,0,5,0,0,5,0,0,0,0,0,0,0,61
2013,"Dominican Rep.",-,5,5,29,158,0,17,214,0,18,5,138,0,0,161,1138
2013,Ecuador,-,12,38,13,37,0,13,113,0,30,14,68,0,18,130,3051
2013,"Equatorial Guinea",-,0,0,5,15,0,16,36,0,0,0,34,17,17,68,256
2013,Eritrea,-,7450,14875,10997,54497,4163,13805,105787,7931,15754,12841,78891,5160,16058,136635,337203
2013,Estonia,-,0,0,0,0,0,8,8,0,0,0,7,0,0,7,371
2013,Ethiopia,-,4699,6475,3961,22361,729,4741,42966,5025,6856,4648,26208,925,4655,48317,129665
2013,Fiji,-,0,0,5,0,0,0,5,0,0,7,15,0,0,22,1572
2013,Finland,-,0,0,0,0,0,0,0,5,0,0,0,0,0,5,10
2013,France,-,0,5,0,6,0,0,11,0,5,5,15,0,0,25,134
2013,Gabon,-,0,0,5,5,0,19,29,0,0,0,33,0,23,56,284
2013,Gambia,-,38,35,18,158,0,88,337,27,30,78,1163,5,78,1381,7199
2013,Palestinian,-,7343,9537,6234,18894,1596,133,43737,8192,6634,11317,21158,1453,415,49169,102731
2013,"United Kingdom of Great Britain and Northern Ireland",-,0,0,0,10,0,0,10,0,5,0,8,0,0,13,206
2013,Georgia,-,10613,10649,11636,75101,26672,1356,136027,11255,11612,12644,63804,16985,1334,117634,275956
2013,Germany,-,5,0,0,5,0,9,19,0,5,5,0,0,0,10,237
2013,Ghana,-,2125,2645,1047,4325,522,217,10881,2075,2862,1148,2736,242,351,9414,26025
2013,Guinea-Bissau,-,11,6,6,93,0,301,417,5,5,56,610,5,653,1334,2415
2013,Greece,-,0,8,10,23,9,0,50,0,5,5,56,14,0,80,188
2013,Grenada,-,0,0,0,20,0,0,20,0,0,6,6,0,0,12,371
2013,Guatemala,-,15,27,38,184,0,5,269,5,19,42,306,0,18,390,15055
2013,Guinea,-,114,91,114,515,10,3606,4450,60,64,423,2280,15,3062,5904,26163
2013,Guyana,-,5,0,0,22,0,0,27,0,5,0,20,0,5,30,936
2013,Haiti,-,102,211,230,3022,70,1621,5256,127,200,240,11052,65,2120,13804,56118
2013,"China, Hong Kong SAR",-,0,0,0,34,0,0,34,0,0,9,0,0,0,9,76
2013,Honduras,-,30,56,42,233,0,0,361,32,48,56,409,5,0,550,8591
2013,Croatia,-,58,456,1506,14674,10216,8402,35312,71,482,1391,16137,5753,7754,31588,67626
2013,Hungary,-,104,180,127,742,67,35,1255,124,170,152,817,186,60,1509,3179
2013,Iceland,-,0,0,0,0,0,0,0,0,0,0,0,0,0,0,5
2013,"Cote d'Ivoire",-,6249,8624,4346,19861,1478,1103,41661,5993,8538,5014,18064,877,1540,40026,120635
2013,India,-,84,86,45,695,13,210,1133,92,109,112,2421,22,196,2952,23914
2013,Indonesia,-,313,420,344,1774,85,6,2942,326,479,392,1201,107,0,2505,15892
2013,Ireland,-,0,7,0,0,0,0,7,0,8,0,0,0,0,8,39
2013,"Iran (Islamic Rep. of)",-,863,1864,1798,14051,1211,1387,21174,905,2154,2169,22443,1595,2503,31769,103869
2013,Iraq,-,71392,132419,129555,191250,33678,2604,560898,83266,97318,94941,276836,22311,3847,578519,1398751
2013,Israel,-,22,23,12,52,5,0,114,11,13,6,100,5,0,135,1315
2013,Italy,-,7,7,0,24,0,7,45,7,8,0,10,0,0,25,141
2013,Jamaica,-,10,11,16,159,0,0,196,0,16,17,167,0,8,208,2131
2013,Jordan,-,24,41,28,251,0,26,370,15,53,41,193,6,44,352,2623
2013,Japan,-,11,21,8,19,0,0,59,29,26,7,11,0,0,73,202
2013,Kazakhstan,-,18,35,18,154,36,273,534,15,46,20,126,0,208,415,3261
2013,Kenya,-,404,536,385,1298,119,54,2796,420,542,344,1015,121,60,2502,10772
2013,Kyrgyzstan,-,23,75,16,165,5,152,436,31,64,27,146,0,310,578,3588
2013,Kiribati,-,0,0,0,0,0,0,0,0,0,0,0,0,0,0,21
2013,"Rep. of Korea",-,13,18,16,44,0,0,91,9,26,20,33,0,0,88,707
2013,"Dem. People's Rep. of Korea",-,48,43,22,327,63,26,529,47,35,40,268,33,29,452,2103
2013,Kuwait,-,0,17,10,33,0,0,60,0,18,7,46,0,11,82,1144
2013,"Lao People's Dem. Rep.",-,0,0,5,7,0,3522,3534,0,0,0,38,5,3895,3938,7777
2013,Liberia,-,392,917,1004,4432,134,91,6970,366,958,1016,4919,219,180,7658,19742
2013,Libya,-,42,62,50,205,5,83,447,62,66,52,578,10,161,929,58950
2013,"Saint Lucia",-,0,31,24,190,0,0,245,12,17,22,115,0,0,166,968
2013,Lebanon,-,51,89,85,442,48,63,778,85,96,116,1058,31,147,1533,6539
2013,Lesotho,-,0,0,0,0,0,0,0,0,0,0,0,0,0,0,686
2013,"Sri Lanka",-,252,456,278,2696,468,41329,45479,256,479,414,9628,275,49796,60848,181405
2013,Lithuania,-,0,0,0,30,0,0,30,7,0,7,27,0,18,59,293
2013,Latvia,-,0,0,0,29,0,21,50,5,6,0,34,0,21,66,294
2013,"China, Macao SAR",-,0,0,0,0,0,0,0,0,0,0,0,0,0,0,5
2013,Madagascar,-,0,10,0,29,0,112,151,0,5,0,7,0,124,136,466
2013,Mauritania,-,2901,3390,1874,4875,424,1173,14637,3112,3390,1880,4714,443,4055,17594,38082
2013,"North Macedonia",-,443,569,450,1724,26,159,3371,502,594,518,1676,49,180,3519,8310
2013,Monaco,-,0,0,0,0,0,0,0,0,0,0,0,0,0,0,5
2013,"Rep. of Moldova",-,10,0,6,107,5,191,319,0,10,10,149,0,194,363,3087
2013,Maldives,-,0,5,0,9,0,0,14,0,0,0,10,0,0,10,54
2013,Mexico,-,19,47,39,259,0,0,364,23,51,45,327,0,10,456,21663
2013,"Marshall Islands",-,0,0,0,0,0,0,0,0,0,0,0,0,0,0,10
2013,Mali,-,12947,20739,8224,32937,3470,2792,81109,13021,20405,8242,23802,2858,954,69282,414163
2013,Malaysia,-,0,6,0,16,0,6,28,0,0,0,10,0,0,10,744
2013,Malawi,-,0,5,0,7,0,0,12,0,0,0,10,0,0,10,4588
2013,Mongolia,-,26,0,19,158,0,209,412,34,21,21,114,0,141,331,3309
2013,Morocco,-,15,25,11,269,5,70,395,18,18,54,1314,5,191,1600,4169
2013,Mozambique,-,0,0,11,12,0,5,28,0,0,0,6,0,7,13,1478
2013,Malta,-,0,0,0,0,0,0,0,0,0,0,0,0,0,0,5
2013,Montenegro,-,35,50,41,174,17,36,353,38,49,30,165,5,31,318,1129
2013,Mauritius,-,0,0,0,12,0,0,12,0,0,0,0,0,6,6,192
2013,Myanmar,-,9879,9274,7079,43355,2124,604,72315,10322,9834,9313,94265,2251,1550,127535,896769
2013,Namibia,-,40,68,50,277,0,0,435,55,66,47,701,21,0,890,1414
2013,Nepal,-,0,10,5,106,0,28,149,0,12,19,351,0,99,481,11881
2013,"Netherlands (Kingdom of the)",-,0,0,0,14,0,0,14,0,0,0,7,0,0,7,84
2013,Niger,-,14,5,12,13,0,38,82,10,5,10,211,0,54,290,36259
2013,Nicaragua,-,12,34,38,324,31,0,439,17,42,47,442,25,0,573,2037
2013,Nigeria,-,803,563,372,2739,75,583,5135,733,554,312,4391,80,538,6608,52505
2013,Niue,-,0,0,0,0,0,0,0,0,0,0,0,0,0,0,14
2013,Norway,-,0,0,0,0,0,0,0,0,0,0,0,5,0,5,20
2013,"New Zealand",-,0,0,5,0,0,0,5,0,0,0,5,0,0,5,21
2013,Oman,-,0,0,0,0,0,0,0,0,0,0,0,0,0,0,20
2013,Pakistan,-,60436,75668,37934,167582,7946,204,349770,75343,98182,60404,168547,15309,789,418574,843717
2013,Panama,-,0,0,12,8,0,0,20,0,0,5,10,0,0,15,126
2013,Paraguay,-,0,0,6,5,0,0,11,0,0,0,15,0,5,20,119
2013,Peru,-,10,21,73,666,61,134,965,6,32,89,731,79,173,1110,5458
2013,Philippines,-,10,8,10,232,0,8,268,0,14,8,54,5,0,81,198993
2013,Palau,-,0,0,0,0,0,0,0,0,0,0,0,0,0,0,5
2013,"Papua New Guinea",-,0,0,0,0,0,0,0,0,0,0,0,0,0,0,365
2013,Poland,-,6,20,17,161,103,103,410,5,13,12,345,267,131,773,1702
2013,Portugal,-,0,5,0,7,0,5,17,0,0,0,14,0,0,14,67
2013,Qatar,-,0,0,0,0,0,0,0,0,0,0,0,0,0,0,15
2013,Romania,-,25,32,38,268,53,93,509,40,43,47,365,95,119,709,3482
2013,"South Africa",-,0,14,22,40,0,5,81,0,8,21,106,15,18,168,776
2013,"Russian Federation",-,1477,1929,1204,6509,405,7755,19279,1617,2187,1426,6380,256,7665,19531,109864
2013,Rwanda,-,5609,11768,8407,16117,725,2006,44632,6149,10392,8263,16427,712,1771,43714,96418
2013,"El Salvador",-,32,52,71,539,42,7,743,40,78,81,788,73,13,1073,20894
2013,"Saudi Arabia",-,0,10,17,17,0,0,44,6,29,5,30,0,0,70,777
2013,"Serbia and Kosovo: S/RES/1244 (1999)",-,2557,11559,15058,78574,25419,6392,139559,2697,12271,16189,81235,20864,7290,140546,303039
2013,Senegal,-,1325,2067,1210,4339,601,468,10010,1338,2050,1328,4830,519,429,10494,24495
2013,Seychelles,-,0,0,0,0,0,0,0,0,0,0,0,0,0,0,24
2013,Singapore,-,0,0,0,7,0,0,7,0,7,0,0,0,0,7,91
2013,"Sierra Leone",-,52,83,95,457,22,194,903,46,79,158,1047,16,317,1663,9239
2013,"Solomon Islands",-,0,0,0,0,0,0,0,0,0,0,0,0,0,0,70
2013,Somalia,-,70475,115077,65474,243634,11970,2113,508743,71307,119072,70420,250188,11592,3012,525591,2291481
2013,Spain,-,0,14,11,13,0,0,38,0,16,0,21,0,5,42,124
2013,"Viet Nam",-,54,93,49,830,147,148382,149555,76,68,68,1362,164,162597,164335,316176
2013,"Saint Kitts and Nevis",-,0,0,0,8,0,0,8,0,0,0,19,0,0,19,33
2013,"Sao Tome and Principe",-,0,0,6,8,0,0,14,0,0,0,12,5,0,17,31
2013,Sudan,-,59886,74552,51226,131234,10783,936594,1264275,61373,73384,49440,102677,8893,939466,1235233,2550614
2013,Suriname,-,0,0,0,0,0,0,0,0,0,0,0,0,0,0,34
2013,"South Sudan",-,9835,15058,10014,25100,1471,11967,73445,10129,16912,13952,18059,486,11968,71506,476240
2013,Slovakia,-,28,28,23,137,14,63,293,29,32,27,152,36,62,338,720
2013,Slovenia,-,0,0,0,10,0,0,10,0,0,0,6,6,0,12,38
2013,Eswatini,-,5,0,0,24,0,0,29,5,0,5,27,0,0,37,249
2013,Sweden,-,0,0,0,5,0,0,5,0,5,0,0,0,0,5,28
2013,Switzerland,-,0,0,0,0,0,0,0,0,0,0,0,0,0,0,11
2013,"Syrian Arab Rep.",-,166827,174175,111858,431962,29552,1287,915661,174097,183920,120231,430766,23208,2648,934870,9039542
2013,"United Rep. of Tanzania",-,16,28,26,48,0,27,145,14,24,7,113,0,19,177,2050
2013,"Turks and Caicos Islands",-,0,0,0,0,0,0,0,0,0,0,5,0,0,5,20
2013,Thailand,-,0,14,28,30,0,0,72,10,17,16,41,0,0,84,393
2013,Tajikistan,-,19,29,16,67,10,17,158,17,46,33,159,0,16,271,1261
2013,Turkmenistan,-,18,12,5,78,5,5,123,20,16,5,68,0,15,124,819
2013,Timor-Leste,-,0,0,0,0,0,0,0,0,0,0,0,0,0,0,18
2013,Togo,-,424,370,306,1224,46,561,2931,413,434,329,2400,76,917,4569,11809
2013,Tonga,-,0,0,0,0,0,0,0,0,0,0,0,0,0,0,77
2013,"Trinidad and Tobago",-,0,5,5,14,0,0,24,0,5,0,12,0,0,17,463
2013,Tunisia,-,14,31,31,133,0,167,376,19,11,30,989,10,377,1436,3149
2013,Türkiye,-,1299,2871,2353,11654,2060,4308,24545,1323,2894,2537,17697,1689,10232,36372,77120
2013,"United Arab Emirates",-,0,7,0,0,0,0,7,0,0,6,0,0,0,6,145
2013,Uganda,-,372,545,342,1154,81,152,2646,398,579,376,829,26,190,2398,61920
2013,Ukraine,-,30,44,35,369,33,415,926,36,63,44,395,14,350,902,6791
2013,Uruguay,-,0,0,0,0,0,0,0,0,0,0,7,0,0,7,166
2013,"United States of America",-,95,206,80,50,5,0,436,75,212,89,66,8,0,450,5046
2013,Uzbekistan,-,34,112,44,238,11,209,648,57,58,59,257,5,225,661,6729
2013,"Saint Vincent and the Grenadines",-,5,20,26,182,0,0,233,5,17,21,111,0,0,154,1758
2013,"Venezuela (Bolivarian Republic of)",-,6,55,28,158,5,8,260,7,27,25,227,5,0,291,9550
2013,Samoa,-,0,0,0,0,0,0,0,0,0,0,7,0,0,7,7
2013,"Western Sahara",-,0,0,0,21,0,11,32,0,0,0,342,0,80,422,116904
2013,Yemen,-,12705,44177,27957,63304,3564,92,151799,12626,47600,33497,58821,4319,98,156961,310901
2013,Zambia,-,0,5,0,6,0,0,11,5,0,0,15,0,0,20,524
2013,Zimbabwe,-,83,109,106,479,16,15,808,98,101,86,684,14,22,1005,121777
2013,Stateless,-,74,139,61,436,51,97,858,82,159,85,813,83,174,1396,25836
2013,Tibetan,-,0,0,0,5,0,7500,7505,0,0,0,9,0,7500,7509,15084
2013,"Curacao ",-,0,0,0,0,0,0,0,0,0,0,0,0,0,0,94
2013,"Unknown ",-,358,506,412,2818,473,1706,6273,464,576,498,7067,816,4274,13695,278863
2014,Afghanistan,-,133878,277623,239386,568439,52752,2097,1274175,136103,286720,257840,626895,75065,7795,1390418,3688436
2014,Albania,-,462,494,332,2106,50,1302,4746,547,561,416,2662,41,1376,5603,25254
2014,Algeria,-,53,46,53,308,0,622,1082,49,41,75,2440,25,999,3629,8648
2014,Andorra,-,0,0,0,0,0,0,0,0,0,0,0,0,0,0,5
2014,Angola,-,5638,7339,4105,14980,1517,1435,35014,5652,7449,4594,14146,1594,1967,35402,75387
2014,"Antigua and Barbuda",-,0,5,0,14,0,0,19,0,0,0,6,0,0,6,68
2014,Egypt,-,182,317,167,823,73,204,1766,216,310,349,2775,67,558,4275,26757
2014,Argentina,-,0,5,11,5,0,5,26,0,5,0,11,8,0,24,413
2014,Armenia,-,161,201,163,1568,228,2085,4406,197,299,213,1698,166,2043,4616,18139
2014,Australia,-,0,0,5,0,0,0,5,0,0,6,0,0,0,6,27
2014,Austria,-,0,0,0,0,0,0,0,0,0,0,0,0,0,0,5
2014,Azerbaijan,-,175,232,152,2071,491,1513,4634,203,303,192,2108,307,1381,4494,637791
2014,Bahrain,-,10,16,0,17,0,0,43,0,7,0,42,0,0,49,449
2014,Barbados,-,0,0,0,12,0,0,12,0,0,0,8,0,0,8,99
2014,Burundi,-,20771,36298,27175,69191,5657,1385,160477,20553,35887,26730,72599,7124,2691,165584,333685
2014,Belgium,-,0,0,5,0,0,0,5,0,0,0,0,0,0,0,97
2014,Benin,-,7,6,20,52,0,11,96,5,0,10,368,0,19,402,1014
2014,Bangladesh,-,34,47,25,261,0,472,839,57,69,69,3906,21,4267,8389,32486
2014,Bahamas,-,0,0,0,5,0,0,5,0,0,0,19,0,5,24,256
2014,Bhutan,-,1132,1480,1258,6406,791,16,11083,1126,1589,1387,6938,1050,98,12188,23823
2014,"Burkina Faso",-,0,10,0,41,0,56,107,0,5,18,371,0,51,445,3419
2014,Belarus,-,32,11,23,102,7,253,428,11,18,29,152,9,315,534,5227
2014,"Bolivia (Plurinational State of)",-,0,12,10,55,0,17,94,0,6,12,94,20,18,150,856
2014,Botswana,-,0,5,0,17,0,0,22,0,0,0,0,0,0,0,303
2014,Brazil,-,5,11,6,16,0,6,44,0,13,18,17,0,14,62,2167
2014,"Bosnia and Herzegovina",-,448,684,617,5495,2744,70226,80214,446,718,759,5955,1699,73084,82661,165386
2014,Bulgaria,-,7,5,6,26,15,36,95,0,5,5,39,43,47,139,1831
2014,Belize,-,0,0,0,9,0,0,9,0,0,0,0,0,0,0,125
2014,Cambodia,-,5,25,12,113,0,6144,6299,11,19,5,94,5,6220,6354,13323
2014,Canada,-,0,7,5,7,0,0,19,0,5,11,5,0,0,21,150
2014,"Central African Rep.",-,32765,51995,32979,95168,5679,1494,220080,32925,50930,32920,78104,6056,1654,202589,879970
2014,"Cayman Islands",-,0,0,0,0,0,0,0,0,0,0,0,0,0,0,6
2014,Chad,-,435,596,743,1117,203,4004,7098,419,531,641,2100,277,4302,8270,86532
2014,China,-,222,227,152,2657,93,1590,4941,184,182,155,3419,105,2406,6451,258128
2014,Chile,-,0,6,5,43,58,45,157,0,0,6,88,75,36,205,669
2014,Cameroon,-,63,91,67,799,28,527,1575,64,71,101,1749,11,1050,3046,15752
2014,Congo,-,104,192,158,647,15,4323,5439,106,190,139,1116,51,5068,6670,18009
2014,"Dem. Rep. of the Congo",-,339448,445187,230365,680921,57585,19494,1773000,340146,444461,235964,553944,35992,24869,1635376,3452998
2014,Comoros,-,0,0,0,10,0,173,183,0,5,5,7,0,346,363,928
2014,Colombia,-,77,201,491,2030,125,3084640,3087564,97,280,534,3041,127,2964095,2968174,6409155
2014,"Costa Rica",-,0,5,0,0,0,0,5,0,0,0,0,0,0,0,539
2014,Cuba,-,5,20,245,605,36,68,979,0,42,67,1450,56,110,1725,9432
2014,"Cabo Verde",-,0,0,0,8,0,0,8,5,5,0,15,0,0,25,73
2014,Cyprus,-,0,0,0,0,0,0,0,0,0,0,0,0,0,0,10
2014,Czechia,-,6,13,5,162,179,21,386,6,10,0,236,330,17,599,1418
2014,Denmark,-,0,0,0,0,0,0,0,0,0,0,0,0,0,0,21
2014,Djibouti,-,12,18,31,68,5,78,212,10,20,25,82,0,63,200,1289
2014,Dominica,-,0,0,0,0,0,0,0,0,0,0,0,0,0,0,48
2014,"Dominican Rep.",-,0,0,17,254,0,19,290,0,5,11,238,0,0,254,1487
2014,Ecuador,-,5,27,6,44,0,13,95,5,10,6,76,0,16,113,7773
2014,"Equatorial Guinea",-,0,0,5,10,0,15,30,0,0,5,32,0,16,53,249
2014,Eritrea,-,8434,17873,14205,72216,4252,7085,124065,8938,18997,17357,119865,5384,9540,180081,416847
2014,Estonia,-,0,0,0,0,0,8,8,0,0,0,5,0,6,11,371
2014,Ethiopia,-,4845,6902,6282,23855,690,5030,47604,5247,7053,5852,29471,804,14948,63375,148632
2014,Fiji,-,0,0,0,5,0,0,5,0,0,0,15,0,0,15,1696
2014,Finland,-,0,0,0,0,0,0,0,0,0,0,0,0,0,0,5
2014,France,-,0,0,0,0,0,0,0,0,5,5,9,5,0,24,124
2014,Gabon,-,0,0,5,10,0,13,28,5,0,5,15,0,18,43,295
2014,Gambia,-,42,38,17,220,0,103,420,36,42,70,2627,5,110,2890,15598
2014,Palestinian,-,7269,9652,6206,19209,1626,156,44118,8064,6798,11226,21955,1506,477,50026,104009
2014,"United Kingdom of Great Britain and Northern Ireland",-,0,0,0,11,0,0,11,0,0,0,6,0,0,6,214
2014,Georgia,-,11339,11943,11925,78336,28743,1433,143719,11926,12970,13174,68418,18297,1425,126210,277194
2014,Germany,-,0,0,0,0,0,8,8,0,0,0,0,0,0,0,247
2014,Ghana,-,2301,2736,1075,4648,544,213,11517,2257,2956,1182,4110,252,386,11143,29735
2014,Guinea-Bissau,-,12,17,5,103,0,294,431,5,5,31,891,5,643,1580,3065
2014,Greece,-,0,5,0,5,5,0,15,0,5,0,18,20,0,43,167
2014,Grenada,-,0,0,0,6,0,0,6,0,0,0,0,0,0,0,376
2014,Guatemala,-,6,23,40,137,0,5,211,0,14,25,208,0,10,257,23287
2014,Guinea,-,138,84,115,614,15,2957,3923,93,58,232,2930,12,2458,5783,33060
2014,Guyana,-,0,0,0,6,0,0,6,0,5,0,13,0,8,26,848
2014,Haiti,-,111,247,237,8791,60,1550,10996,130,428,208,21051,97,1973,23887,73106
2014,"China, Hong Kong SAR",-,0,0,0,0,0,0,0,0,0,0,0,0,0,0,63
2014,Honduras,-,18,27,40,162,0,0,247,18,45,43,267,0,0,373,14293
2014,Croatia,-,17,331,1194,11545,8014,69,21170,14,368,1097,12616,4584,60,18739,56026
2014,Hungary,-,39,47,30,208,63,24,411,45,61,25,236,167,50,584,1606
2014,Iceland,-,0,0,0,0,0,0,0,0,0,0,0,0,0,0,5
2014,"Cote d'Ivoire",-,4911,6809,3893,15833,1055,1206,33707,4739,6861,4282,15534,676,1533,33625,109401
2014,India,-,95,103,45,738,0,212,1193,138,115,73,2531,15,213,3085,27510
2014,Indonesia,-,22,5,5,909,0,6,947,25,7,14,10,9,0,65,16158
2014,Ireland,-,0,6,0,0,0,0,6,0,0,0,0,0,0,0,89
2014,"Iran (Islamic Rep. of)",-,1001,2132,2600,17010,1464,1335,25542,1012,2313,4242,27325,1848,2395,39135,117111
2014,Iraq,-,10795,17038,16816,50559,5846,4165,105219,11527,18400,17787,72775,5536,5275,131300,4073347
2014,Israel,-,8,5,9,21,0,5,48,5,11,0,51,0,0,67,1249
2014,Italy,-,5,5,6,17,0,7,40,12,0,5,10,0,0,27,173
2014,Jamaica,-,10,7,5,96,0,5,123,0,6,11,99,0,5,121,2279
2014,Jordan,-,38,66,37,278,5,16,440,25,60,43,233,5,40,406,3106
2014,Japan,-,23,44,18,5,0,0,90,42,62,22,5,0,0,131,318
2014,Kazakhstan,-,29,42,16,116,25,277,505,25,33,35,99,5,216,413,3366
2014,Kenya,-,334,522,461,1415,152,158,3042,321,553,418,1128,140,142,2702,11471
2014,Kyrgyzstan,-,21,58,25,167,11,224,506,50,68,26,157,0,239,540,4283
2014,Kiribati,-,0,0,0,0,0,0,0,0,0,0,0,0,0,0,5
2014,"Rep. of Korea",-,8,16,27,21,0,0,72,15,21,24,24,0,5,89,760
2014,"Dem. People's Rep. of Korea",-,7,0,0,61,10,78,156,0,7,0,72,5,85,169,1508
2014,Kuwait,-,10,20,15,13,0,0,58,0,7,10,21,0,9,47,1234
2014,"Lao People's Dem. Rep.",-,0,0,0,6,5,3411,3422,0,0,0,36,5,3768,3809,7589
2014,Liberia,-,425,793,814,3215,136,108,5491,382,846,799,3751,187,253,6218,15888
2014,Libya,-,101,118,63,303,0,91,676,101,147,69,789,9,174,1289,371145
2014,"Saint Lucia",-,0,0,5,16,0,0,21,0,6,0,6,0,0,12,956
2014,Lebanon,-,82,123,131,624,59,41,1060,108,149,164,1594,43,126,2184,8095
2014,Lesotho,-,0,0,0,5,0,5,10,0,0,0,0,0,0,0,681
2014,"Sri Lanka",-,259,397,270,2550,442,41091,45009,268,399,362,8639,269,50106,60043,170064
2014,Lithuania,-,0,0,0,6,0,0,6,0,0,0,0,0,17,17,239
2014,Latvia,-,0,0,0,5,0,21,26,0,5,0,17,0,20,42,263
2014,"China, Macao SAR",-,0,0,0,0,0,0,0,0,0,0,0,0,5,5,16
2014,Madagascar,-,0,5,0,17,0,103,125,0,0,6,0,0,111,117,484
2014,Mauritania,-,2907,3382,1875,4875,424,1162,14625,3112,3383,1872,4675,443,3896,17381,41105
2014,"North Macedonia",-,524,673,503,2043,49,179,3971,634,695,524,1989,57,191,4090,9540
2014,Monaco,-,0,0,0,0,0,0,0,0,0,0,0,0,0,0,11
2014,"Rep. of Moldova",-,6,11,5,84,5,179,290,10,10,15,183,0,182,400,3670
2014,Maldives,-,0,5,0,0,0,0,5,0,0,0,5,0,0,5,37
2014,Mexico,-,5,10,22,61,0,5,103,0,5,19,58,0,6,88,40023
2014,"Marshall Islands",-,0,0,0,0,0,0,0,0,0,0,0,0,0,0,11
2014,Mali,-,10476,19074,7944,29500,2868,3035,72897,10605,18890,7991,20525,2487,989,61487,251295
2014,Malaysia,-,0,7,0,0,0,7,14,0,0,0,5,0,0,5,1406
2014,Malawi,-,0,0,0,0,0,10,10,0,0,0,0,0,13,13,4247
2014,Mongolia,-,63,24,12,310,6,214,629,65,38,24,251,0,145,523,4366
2014,Morocco,-,35,24,18,317,7,74,475,38,23,77,1577,10,224,1949,4757
2014,Mozambique,-,6,0,6,15,0,10,37,0,7,0,17,0,5,29,1463
2014,Montenegro,-,96,111,85,323,19,91,725,103,141,85,296,11,90,726,1874
2014,Mauritius,-,0,0,0,0,0,5,5,0,0,0,0,0,5,5,242
2014,Myanmar,-,12492,12278,9597,53339,2897,644,91247,13091,13157,11590,107287,2920,1583,149628,907245
2014,Namibia,-,43,54,48,136,0,5,286,51,68,35,557,34,0,745,1295
2014,Nepal,-,0,17,0,85,0,26,128,0,0,11,336,0,105,452,15186
2014,"Netherlands (Kingdom of the)",-,5,0,0,5,0,0,10,5,6,0,5,0,0,16,103
2014,Niger,-,6,5,15,14,0,17,57,8,5,15,204,0,39,271,1263
2014,Nicaragua,-,0,0,0,92,18,0,110,0,0,0,159,7,0,166,2298
2014,Nigeria,-,1376,1057,916,3673,74,630660,637756,1311,992,861,6518,102,558655,568439,1379042
2014,Niue,-,0,0,0,0,0,0,0,0,0,0,0,0,0,0,46
2014,Norway,-,0,0,0,0,0,0,0,0,0,0,0,0,0,0,15
2014,"New Zealand",-,0,0,0,0,0,0,0,0,0,0,9,0,0,9,27
2014,Oman,-,0,0,0,0,0,0,0,0,0,0,0,0,5,5,34
2014,Pakistan,-,144268,164089,91860,379635,17064,209,797125,158103,208216,130655,355855,33540,1127,887496,1756270
2014,Panama,-,0,0,0,0,0,0,0,0,0,6,0,0,0,6,111
2014,Paraguay,-,0,0,0,8,0,0,8,0,0,0,15,0,5,20,121
2014,Peru,-,0,0,45,517,64,125,751,0,7,61,569,65,174,876,5362
2014,Philippines,-,10,13,26,237,5,72644,72935,15,9,5,29,0,69796,69854,224260
2014,"Papua New Guinea",-,0,0,0,0,0,0,0,0,0,0,0,0,0,0,498
2014,Poland,-,6,5,6,107,101,72,297,0,5,11,246,269,89,620,1569
2014,Portugal,-,0,0,0,0,0,5,5,0,0,0,5,5,0,10,64
2014,Qatar,-,0,0,0,0,0,0,0,0,0,0,0,0,0,0,28
2014,Romania,-,5,13,15,44,35,80,192,7,8,10,80,85,99,289,2933
2014,"South Africa",-,0,13,0,37,0,6,56,0,12,5,195,10,18,240,953
2014,"Russian Federation",-,1349,1794,994,5031,315,7316,16799,1523,2000,1175,4829,195,6908,16630,95052
2014,Rwanda,-,5648,9720,6630,17982,1035,2398,43413,5785,9396,6624,19530,1090,2428,44853,94260
2014,"El Salvador",-,18,37,53,273,36,6,423,34,26,30,371,55,12,528,29003
2014,"Saudi Arabia",-,5,0,20,24,0,5,54,5,16,5,46,0,0,72,1008
2014,"Serbia and Kosovo: S/RES/1244 (1999)",-,3394,12322,15127,78950,24835,6402,141030,3502,13036,16448,81962,20439,7181,142568,314442
2014,Senegal,-,1205,2690,1925,4216,533,476,11045,1181,2848,1879,6720,457,262,13347,31827
2014,Seychelles,-,0,0,0,0,0,5,5,0,0,0,0,0,0,0,35
2014,Singapore,-,0,0,0,0,0,0,0,0,7,0,0,0,0,7,86
2014,"Sierra Leone",-,63,106,116,501,22,186,994,53,95,106,1182,16,343,1795,9618
2014,"Solomon Islands",-,0,0,0,0,0,5,5,0,0,0,0,0,7,7,90
2014,Somalia,-,63707,114832,68603,223383,13519,9145,493189,66151,119483,76343,251942,12588,36439,562946,2289294
2014,Spain,-,0,7,5,10,0,0,22,5,6,5,13,0,5,34,128
2014,"Viet Nam",-,66,119,79,1064,159,148170,149657,90,100,74,1666,176,162288,164394,316620
2014,"Saint Kitts and Nevis",-,0,0,0,9,0,0,9,0,7,0,0,0,0,7,27
2014,"Sao Tome and Principe",-,0,0,5,11,0,0,16,8,0,0,0,0,5,13,29
2014,Sudan,-,61048,77174,57516,138332,11606,1096900,1442576,62864,76832,61241,107343,9627,1099134,1417041,2894818
2014,Suriname,-,0,0,0,0,0,0,0,0,0,0,5,0,0,5,63
2014,"South Sudan",-,49258,79784,46993,120091,8641,25268,330035,50607,83004,54941,77243,4277,19637,289709,2265364
2014,Slovakia,-,29,27,8,114,15,61,254,28,21,30,133,34,59,305,643
2014,Slovenia,-,0,0,0,0,0,0,0,0,0,0,0,9,0,9,30
2014,Eswatini,-,0,0,0,5,0,5,10,0,0,0,5,0,7,12,296
2014,Sweden,-,5,0,0,5,0,0,10,0,0,0,0,0,0,0,28
2014,Switzerland,-,0,0,0,0,0,0,0,0,0,0,0,0,0,0,16
2014,"Syrian Arab Rep.",-,211178,246805,182954,568315,41882,2690,1253824,220262,260130,193991,537971,33187,5051,1250592,11601631
2014,"United Rep. of Tanzania",-,16,28,15,79,0,29,167,8,26,5,126,0,26,191,1899
2014,"Turks and Caicos Islands",-,0,0,0,0,0,0,0,0,0,0,0,0,0,0,15
2014,Thailand,-,0,15,19,33,0,0,67,0,9,20,16,0,0,45,633
2014,Tajikistan,-,32,83,20,116,5,18,274,35,65,69,258,0,27,454,1560
2014,Turkmenistan,-,38,35,17,292,7,6,395,41,39,13,176,0,17,286,1213
2014,Timor-Leste,-,0,0,0,0,0,0,0,0,0,0,0,0,0,0,20
2014,Togo,-,233,366,257,1232,54,544,2686,236,381,256,2332,91,861,4157,10962
2014,Tonga,-,0,0,0,0,0,0,0,0,0,0,0,0,0,0,101
2014,"Trinidad and Tobago",-,0,0,0,17,0,0,17,0,0,0,0,0,0,0,544
2014,Tunisia,-,6,42,17,142,0,169,376,17,19,50,798,10,436,1330,3269
2014,Türkiye,-,1835,2801,2022,11186,2081,4110,24035,1813,2789,2228,17351,1734,9797,35712,75082
2014,"United Arab Emirates",-,0,0,0,0,0,0,0,0,0,0,9,0,0,9,152
2014,Uganda,-,225,317,269,1155,43,236,2245,234,323,237,1087,26,568,2475,191925
2014,Ukraine,-,197,350,170,1598,224,697636,700175,239,293,197,1557,99,357969,360354,1075707
2014,Uruguay,-,0,0,0,0,0,0,0,0,0,0,0,0,0,0,161
2014,"United States of America",-,26,59,30,30,5,0,150,25,59,37,40,8,0,169,5161
2014,Uzbekistan,-,36,50,97,313,6,189,691,42,43,97,245,5,171,603,6770
2014,"Saint Vincent and the Grenadines",-,0,0,5,37,0,0,42,8,0,0,22,0,0,30,1781
2014,"Venezuela (Bolivarian Republic of)",-,20,19,22,155,0,6,222,11,19,13,324,0,6,373,12831
2014,Samoa,-,0,0,0,0,0,0,0,0,0,0,0,0,0,0,7
2014,"Western Sahara",-,0,0,0,18,0,23,41,0,0,0,238,0,174,412,117654
2014,Yemen,-,13772,48520,30720,69774,3925,100,166811,13646,51669,36398,63622,4696,123,170154,339445
2014,Zambia,-,0,0,0,11,0,57,68,0,0,0,11,0,28,39,602
2014,Zimbabwe,-,87,89,72,366,14,2704,3332,81,87,59,542,10,3620,4399,65013
2014,Stateless,-,114,194,153,685,65,34,1245,130,250,207,1416,95,95,2193,38439
2014,Tibetan,-,0,0,0,5,0,7500,7505,0,0,5,0,0,7500,7505,15081
2014,Guadeloupe,-,0,0,0,0,0,0,0,0,0,0,0,0,0,0,12
2014,"Curacao ",-,0,0,0,0,0,0,0,0,0,0,0,0,0,0,35
2014,"Unknown ",-,1178,2299,1729,9913,766,114718,130603,1276,2377,1793,13475,1042,280117,300080,573337
2015,Afghanistan,-,189674,328776,261575,638919,48179,4181,1471304,195971,353590,294227,741878,70047,11792,1667505,4249831
2015,Albania,-,2049,2214,1413,8563,118,1743,16100,2232,2507,1857,12332,132,1863,20923,52559
2015,Algeria,-,57,48,32,402,15,660,1214,57,49,93,3479,29,945,4652,11104
2015,Andorra,-,0,0,0,0,0,0,0,0,0,0,0,0,0,0,10
2015,Angola,-,3374,4301,2303,9042,697,1499,21216,3181,4208,2330,8367,957,3692,22735,50071
2015,"Antigua and Barbuda",-,0,0,0,0,0,0,0,0,0,0,7,0,0,7,68
2015,Egypt,-,190,294,169,849,33,252,1787,191,340,281,3547,54,660,5073,30149
2015,Argentina,-,0,6,0,10,0,5,21,0,5,0,25,0,0,30,346
2015,Armenia,-,231,275,215,2004,272,2231,5228,294,368,285,2093,219,2170,5429,19716
2015,Australia,-,0,0,0,0,0,0,0,0,5,0,0,0,0,5,21
2015,Austria,-,0,0,0,0,0,0,0,0,0,0,0,0,0,0,5
2015,Azerbaijan,-,230,309,166,2249,516,1630,5100,260,408,222,2317,314,1512,5033,633139
2015,Bahrain,-,0,11,10,9,0,0,30,5,11,7,52,0,5,80,503
2015,Barbados,-,0,0,0,5,0,0,5,0,0,0,11,0,0,11,119
2015,Burundi,-,36495,53339,43604,111351,7925,355,253069,36803,51138,41292,108188,6696,381,244498,508626
2015,Belgium,-,5,0,12,0,0,0,17,0,0,5,5,0,0,10,103
2015,Benin,-,9,0,5,100,0,37,151,5,16,24,638,0,30,713,1547
2015,Bangladesh,-,41,49,18,268,5,510,891,55,65,51,3672,18,3601,7462,42714
2015,Bahamas,-,0,0,0,15,0,0,15,0,7,0,20,0,0,27,296
2015,Bhutan,-,824,1170,964,4668,565,17,8208,875,1219,1017,5159,780,102,9152,17932
2015,"Burkina Faso",-,9,0,0,61,0,102,172,5,0,17,429,0,89,540,4838
2015,Belarus,-,17,20,24,198,8,285,552,24,34,49,229,16,342,694,5589
2015,"Bolivia (Plurinational State of)",-,0,18,12,65,5,17,117,0,25,0,103,7,18,153,908
2015,Botswana,-,0,10,0,15,0,0,25,0,0,0,0,0,0,0,379
2015,Brazil,-,0,7,5,33,0,11,56,5,5,15,31,0,5,61,3044
2015,"Brunei Darussalam",-,0,0,0,0,0,0,0,0,0,0,0,0,0,0,5
2015,"Bosnia and Herzegovina",-,412,572,515,4685,2265,76767,85216,458,623,639,4977,1347,80009,88053,176539
2015,Bulgaria,-,0,5,5,41,13,37,101,0,0,10,47,42,55,154,1471
2015,Belize,-,0,0,0,0,0,0,0,0,0,0,0,0,0,0,201
2015,Cambodia,-,5,15,24,119,5,6053,6221,10,11,24,104,5,6122,6276,13174
2015,Canada,-,0,7,0,5,0,0,12,0,8,6,0,0,0,14,413
2015,"Central African Rep.",-,39299,62786,38076,104835,6313,130573,381882,39292,61753,36327,84354,6363,87462,315551,718911
2015,"Cayman Islands",-,0,0,0,0,0,0,0,0,0,0,0,0,0,0,6
2015,Chad,-,1085,1507,1020,3024,315,376,7327,1156,1385,988,3209,258,52939,59935,100187
2015,China,-,107,165,126,2176,68,2277,4919,94,150,108,2603,116,3147,6218,270604
2015,Chile,-,0,0,5,76,36,60,177,0,0,0,90,75,59,224,703
2015,Cameroon,-,130,167,80,1075,30,47710,49192,110,149,129,2290,28,46316,49022,110584
2015,Congo,-,126,160,142,685,18,1622,2753,89,170,154,1178,49,1721,3361,18931
2015,"Dem. Rep. of the Congo",-,218134,250325,128243,448087,25508,7300,1077597,215169,248149,135707,398753,21162,8183,1027123,2182551
2015,Comoros,-,0,0,0,5,0,187,192,0,6,0,5,0,338,349,776
2015,Colombia,-,149,3823,10668,10887,724,3341,29592,172,3893,10580,14537,976,3813,33971,7286062
2015,"Costa Rica",-,0,5,0,0,0,0,5,0,0,0,0,0,0,0,587
2015,Cuba,-,0,10,57,762,53,71,953,0,27,43,1545,83,128,1826,9255
2015,"Cabo Verde",-,0,5,0,24,0,0,29,0,10,0,44,0,0,54,122
2015,Cyprus,-,0,0,0,0,0,0,0,0,0,0,0,0,0,0,5
2015,Czechia,-,0,12,14,189,178,12,405,8,5,13,259,342,29,656,1399
2015,Denmark,-,0,0,0,0,0,0,0,0,0,0,0,0,0,0,26
2015,Djibouti,-,0,23,8,61,5,223,320,0,23,7,74,0,162,266,1601
2015,Dominica,-,0,0,0,0,0,0,0,0,0,0,0,0,0,0,124
2015,"Dominican Rep.",-,0,5,14,251,6,25,301,0,5,6,561,0,5,577,2091
2015,Ecuador,-,0,22,16,35,0,13,86,0,6,9,78,0,15,108,11421
2015,"Equatorial Guinea",-,5,0,0,5,0,15,25,0,5,0,26,5,15,51,227
2015,Eritrea,-,9044,18450,14103,78438,4443,6221,130699,9735,19558,19855,138950,5709,6408,200215,469751
2015,Estonia,-,0,0,0,0,0,8,8,0,0,0,7,0,0,7,354
2015,Ethiopia,-,4886,6956,4644,26909,723,653,44771,5279,7298,5212,31511,840,644,50784,162740
2015,Fiji,-,0,0,0,0,0,0,0,0,0,0,15,0,0,15,1316
2015,Finland,-,0,0,0,0,0,0,0,0,0,0,0,0,0,0,10
2015,France,-,0,0,0,6,0,0,6,0,5,0,23,5,0,33,167
2015,"Micronesia (Federated States of)",-,0,0,0,0,0,0,0,0,0,0,0,0,0,0,6
2015,Gabon,-,0,0,0,17,0,26,43,0,0,0,10,0,26,36,398
2015,Gambia,-,65,48,19,305,0,136,573,48,37,139,5146,5,104,5479,21293
2015,Palestinian,-,6987,9572,6081,19309,1718,217,43884,7734,6755,11254,21790,1583,533,49649,104748
2015,"United Kingdom of Great Britain and Northern Ireland",-,0,0,0,5,0,0,5,0,0,0,7,0,0,7,237
2015,Georgia,-,11633,12951,11997,79177,29734,1510,147002,12234,13949,13289,69912,18835,1464,129683,284166
2015,Germany,-,0,0,0,0,0,7,7,0,0,0,0,0,0,0,239
2015,Ghana,-,2307,2746,1075,4893,551,210,11782,2268,2974,1156,3890,257,384,10929,33667
2015,Guinea-Bissau,-,11,17,11,129,0,314,482,5,5,34,858,5,636,1543,3393
2015,Greece,-,0,0,6,5,5,0,16,0,12,0,14,23,0,49,176
2015,Grenada,-,0,0,0,0,0,0,0,5,0,0,0,0,0,5,321
2015,Guatemala,-,5,12,19,30,5,696,767,6,12,16,66,0,2833,2933,40735
2015,Guinea,-,119,130,70,720,5,5454,6498,103,86,249,3101,12,3784,7335,34827
2015,Guyana,-,0,0,0,9,0,5,14,0,8,0,13,0,8,29,731
2015,Haiti,-,31,245,161,1393,51,1518,3399,27,216,144,5699,76,1932,8094,50289
2015,"China, Hong Kong SAR",-,0,0,0,0,0,0,0,0,5,0,0,0,0,5,113
2015,Honduras,-,10005,12721,13734,50125,4300,0,90885,11105,15915,12533,45462,3600,0,88615,205403
2015,Croatia,-,86,342,1078,9739,6419,7366,25030,67,359,1060,10511,3511,6798,22306,47611
2015,Hungary,-,28,37,41,187,64,41,398,26,37,37,219,172,88,579,2155
2015,Iceland,-,0,0,0,0,0,0,0,0,0,0,0,0,0,0,5
2015,"Cote d'Ivoire",-,4304,6995,4284,14652,1015,1384,32634,4179,6902,4633,14671,645,1576,32606,393175
2015,India,-,103,112,59,1142,11,66,1493,139,128,92,3844,24,199,4426,35134
2015,Indonesia,-,21,0,6,1094,0,6,1127,26,13,0,5,8,0,52,16584
2015,Ireland,-,0,6,0,0,0,0,6,0,0,0,0,0,0,0,41
2015,"Iran (Islamic Rep. of)",-,1285,2544,2288,20245,1543,1903,29808,1332,2825,2893,33448,2018,2887,45403,142039
2015,Iraq,-,14497,23325,16070,75861,8298,5090,143141,15471,25521,18924,112392,7909,8030,188247,4908139
2015,Israel,-,0,9,7,27,5,5,53,0,7,5,48,0,15,75,1166
2015,Italy,-,8,0,6,20,0,0,34,8,0,6,18,0,6,38,208
2015,Jamaica,-,0,0,14,63,0,5,82,6,12,0,69,0,8,95,2696
2015,Jordan,-,31,64,32,354,10,30,521,24,58,56,327,5,54,524,3757
2015,Japan,-,6,26,9,5,0,0,46,13,30,12,5,0,0,60,208
2015,Kazakhstan,-,13,36,13,132,29,299,522,22,32,23,164,5,256,502,3828
2015,Kenya,-,325,442,357,1262,153,69,2608,359,471,342,965,127,43,2307,11172
2015,Kyrgyzstan,-,25,43,26,218,10,185,507,25,68,43,178,0,195,509,4761
2015,Kiribati,-,0,0,0,0,0,0,0,0,0,0,0,0,0,0,5
2015,"Rep. of Korea",-,0,10,14,29,0,0,53,8,7,13,25,0,0,53,598
2015,"Dem. People's Rep. of Korea",-,5,6,0,69,0,34,114,0,9,0,82,5,29,125,1317
2015,Kuwait,-,0,5,18,30,0,0,53,0,7,0,50,0,16,73,1507
2015,"Lao People's Dem. Rep.",-,0,0,0,5,6,3383,3394,0,0,0,38,6,3710,3754,7524
2015,Liberia,-,294,546,488,2436,81,89,3934,264,529,541,2821,128,187,4470,12394
2015,Libya,-,159,184,102,555,5,152,1157,130,222,130,1461,24,216,2183,446993
2015,"Saint Lucia",-,0,0,0,5,0,0,5,0,0,0,7,0,0,7,1071
2015,Lebanon,-,122,191,130,943,80,98,1564,148,236,178,2333,47,178,3120,10338
2015,Lesotho,-,0,0,0,5,0,0,5,0,0,0,5,0,0,5,1107
2015,"Sri Lanka",-,237,324,233,2344,431,40935,44504,236,336,369,7565,263,49033,57802,181160
2015,Lithuania,-,0,0,0,10,0,0,10,0,0,0,9,0,19,28,207
2015,Latvia,-,0,0,0,11,0,20,31,0,0,0,17,0,19,36,264
2015,"China, Macao SAR",-,0,0,0,0,0,0,0,0,0,0,0,0,0,0,30
2015,Madagascar,-,0,5,0,16,0,109,130,0,0,0,5,0,112,117,456
2015,Mauritania,-,2528,3444,1977,5472,444,1239,15104,2614,3493,1905,5234,522,4038,17806,42135
2015,"North Macedonia",-,767,908,614,2882,79,266,5516,851,1024,735,2888,87,269,5854,16378
2015,Monaco,-,0,0,0,0,0,0,0,0,0,0,0,0,0,0,5
2015,"Rep. of Moldova",-,78,82,35,512,17,174,898,90,86,49,826,14,183,1248,5726
2015,Maldives,-,0,5,0,0,0,0,5,0,0,0,0,0,0,0,67
2015,Mexico,-,0,12,5,48,0,6,71,5,5,16,37,0,15,78,57590
2015,"Marshall Islands",-,0,0,0,0,0,0,0,0,0,0,0,0,0,0,11
2015,Mali,-,10348,20813,9653,32297,3029,3195,79335,10605,20682,9610,22435,2760,959,67051,226027
2015,Malaysia,-,0,6,0,5,0,12,23,0,0,5,5,0,0,10,3258
2015,Malawi,-,20,5,6,85,0,0,116,6,5,5,76,0,0,92,6101
2015,Mongolia,-,65,34,18,313,11,227,668,66,54,21,262,5,157,565,5727
2015,Morocco,-,38,40,11,465,5,101,660,38,22,79,2132,11,246,2528,7346
2015,Mozambique,-,0,0,6,19,0,5,30,0,0,0,52,0,5,57,2248
2015,Malta,-,0,0,0,0,0,0,0,0,0,0,0,0,0,0,5
2015,Montenegro,-,228,280,184,776,28,73,1569,241,308,173,783,19,66,1590,3661
2015,Mauritius,-,11,6,0,18,0,5,40,0,0,7,23,0,5,35,303
2015,Myanmar,-,33035,29716,23762,99793,8184,59,194549,32926,30989,27680,145272,7423,295,244585,963968
2015,Namibia,-,43,64,44,135,0,0,286,33,85,39,508,30,0,695,1368
2015,Nepal,-,5,0,0,87,0,46,138,0,10,5,460,0,103,578,18012
2015,"Netherlands (Kingdom of the)",-,5,0,0,6,0,0,11,0,0,0,6,0,0,6,119
2015,Niger,-,38,45,40,115,19,114511,114768,38,60,33,346,7,92971,93455,209483
2015,Nicaragua,-,0,0,5,180,24,0,209,0,0,0,387,12,0,399,2706
2015,Nigeria,-,6076,7463,3568,15777,971,38485,72340,6176,7502,3530,16759,990,31251,66208,2391877
2015,Niue,-,0,0,0,0,0,0,0,0,0,0,0,0,0,0,36
2015,Norway,-,0,5,0,0,0,0,5,0,0,0,0,0,0,0,15
2015,"New Zealand",-,0,0,0,0,0,0,0,0,0,0,8,0,0,8,23
2015,Oman,-,0,0,0,0,0,0,0,0,5,0,0,0,0,5,52
2015,Pakistan,-,116774,135871,84305,289362,28649,248,655209,136211,182349,108983,306392,30126,1454,765515,1507949
2015,Panama,-,0,5,5,0,0,0,10,0,0,0,0,0,0,0,121
2015,Paraguay,-,5,0,0,18,0,0,23,0,0,0,36,0,5,41,155
2015,Peru,-,0,9,53,495,68,143,768,0,10,51,580,80,166,887,5121
2015,Philippines,-,19,11,0,367,10,32219,32626,8,14,11,121,0,30955,31109,145699
2015,"Papua New Guinea",-,0,0,0,0,0,0,0,0,0,0,0,0,0,0,533
2015,Poland,-,7,0,14,118,107,136,382,0,7,0,249,286,180,722,1697
2015,Portugal,-,8,0,0,5,0,5,18,0,5,0,10,5,0,20,92
2015,Qatar,-,0,0,0,0,0,0,0,0,0,0,0,0,0,0,33
2015,Romania,-,0,0,16,160,47,83,306,5,7,16,237,105,114,484,3108
2015,"South Africa",-,11,23,10,148,0,9,201,10,14,12,417,8,26,487,1296
2015,"Russian Federation",-,1302,1892,1038,5166,374,8784,18556,1418,2078,1162,4883,234,8351,18126,94521
2015,Rwanda,-,29546,37806,25958,50715,2728,1944,148697,26081,38603,27161,50274,3485,1785,147389,303106
2015,"El Salvador",-,35,66,437,2487,205,12,3242,46,49,495,7631,263,12,8496,56328
2015,"Saudi Arabia",-,5,11,10,51,0,5,82,0,19,0,25,0,0,44,1257
2015,"Serbia and Kosovo: S/RES/1244 (1999)",-,3648,12448,15126,78332,24055,6173,139782,3874,13329,16340,83366,19818,6886,143613,311914
2015,Senegal,-,467,818,556,2038,225,645,4749,418,850,603,9056,283,598,11808,35568
2015,Seychelles,-,0,5,0,0,0,0,5,0,0,0,0,0,0,0,39
2015,Singapore,-,0,0,0,5,0,0,5,0,0,6,5,0,0,11,95
2015,"Sierra Leone",-,73,90,115,573,20,207,1078,44,91,135,1515,20,1799,3604,9865
2015,"Solomon Islands",-,0,0,0,0,0,0,0,0,0,0,0,0,0,0,108
2015,Somalia,-,189805,234976,151612,457233,31358,3513,1068497,183830,247404,158727,470882,30545,4393,1095781,2313636
2015,Spain,-,0,17,5,10,0,0,32,0,13,0,15,9,0,37,145
2015,"Viet Nam",-,77,136,88,1208,175,3660,5344,109,125,115,1883,194,4592,7018,317790
2015,"Saint Kitts and Nevis",-,0,0,0,0,0,0,0,0,5,0,0,0,0,5,45
2015,"Sao Tome and Principe",-,0,0,5,11,0,0,16,8,0,0,5,0,5,18,34
2015,Sudan,-,52686,79034,48621,140777,11788,700,333606,54624,79679,48625,111411,9304,3883,307526,3888243
2015,Suriname,-,0,0,0,0,0,0,0,0,0,0,0,0,0,0,68
2015,"South Sudan",-,60469,90719,56081,131411,9761,740268,1088709,61955,95174,63111,80908,4167,1082035,1387350,2573283
2015,Slovakia,-,41,33,22,158,18,57,329,36,49,30,180,34,57,386,866
2015,Slovenia,-,0,0,0,0,0,0,0,0,0,0,0,7,0,7,31
2015,Eswatini,-,0,0,0,9,0,0,9,0,0,0,16,0,0,16,372
2015,Sweden,-,0,0,0,5,0,0,5,0,0,0,5,0,0,5,33
2015,Switzerland,-,0,0,0,0,0,0,0,0,0,0,0,0,0,0,16
2015,"Syrian Arab Rep.",-,176982,228104,133453,537172,37210,5288,1118209,185521,241972,146347,587969,29838,8123,1199770,11690802
2015,"United Rep. of Tanzania",-,19,25,31,79,0,45,199,11,21,12,215,0,27,286,2402
2015,"Turks and Caicos Islands",-,0,0,0,0,0,0,0,0,0,0,0,0,0,0,14
2015,Thailand,-,0,8,15,89,0,0,112,0,5,13,50,0,5,73,1042
2015,Tajikistan,-,37,107,21,190,5,32,392,40,86,55,366,5,35,587,2241
2015,Turkmenistan,-,54,58,22,467,17,18,636,50,56,32,270,7,21,436,1651
2015,Timor-Leste,-,0,0,0,0,0,0,0,0,0,0,0,0,0,0,24
2015,Togo,-,220,356,297,1280,75,288,2516,248,454,239,2515,121,600,4177,10902
2015,Tonga,-,0,0,0,0,0,0,0,0,0,0,0,0,0,0,84
2015,"Trinidad and Tobago",-,0,0,5,0,0,0,5,5,0,0,6,0,0,11,569
2015,Tunisia,-,36,35,55,191,0,81,398,47,46,51,989,12,242,1387,3890
2015,Türkiye,-,528,1709,2075,12075,2361,3201,21949,593,1793,2281,17206,2021,8150,32044,71630
2015,"United Arab Emirates",-,0,0,11,0,0,0,11,0,0,0,9,0,0,9,194
2015,Uganda,-,18130,18156,18143,19097,18010,80,91616,18119,18139,18143,19423,18029,87,91940,192737
2015,Ukraine,-,403,533,286,2728,320,818,5088,464,565,316,2759,136,645,4885,1943754
2015,Uruguay,-,0,0,0,5,0,0,5,0,0,0,0,0,0,0,146
2015,"United States of America",-,31,53,33,20,10,0,147,30,29,33,44,10,0,146,5079
2015,Uzbekistan,-,30,77,55,434,6,156,758,26,63,85,286,5,141,606,6856
2015,"Saint Vincent and the Grenadines",-,0,0,0,12,0,0,12,0,0,0,15,0,0,15,1866
2015,"Venezuela (Bolivarian Republic of)",-,26,103,32,453,7,21,642,22,82,22,946,6,17,1095,22542
2015,Samoa,-,0,0,0,0,0,0,0,0,0,0,0,0,0,0,9
2015,"Western Sahara",-,0,0,0,17,0,38,55,0,0,0,169,0,266,435,117980
2015,Yemen,-,110384,370726,233632,620168,41411,59,1376380,94127,327825,234231,474360,46932,90,1177565,2558001
2015,Zambia,-,0,5,0,11,0,0,16,0,0,0,11,0,0,11,761
2015,Zimbabwe,-,73,119,73,539,8,13,825,81,110,68,545,11,21,836,78843
2015,Stateless,-,213,353,231,1288,101,63,2249,231,457,375,3194,166,98,4521,56016
2015,Tibetan,-,0,0,0,7500,0,0,7500,0,0,0,7511,0,0,7511,15085
2015,Guadeloupe,-,0,0,0,0,0,0,0,0,0,0,0,0,0,0,23
2015,"Curacao ",-,0,0,0,0,0,0,0,0,0,0,0,0,0,0,35
2015,"Unknown ",-,1537,2191,1549,11172,2042,9135,27626,1748,2484,2155,18848,2244,19229,46708,1181681
2016,Afghanistan,-,279667,351603,283722,702496,69095,3550,1690133,306880,355761,330722,854745,90529,11676,1950313,4782291
2016,Albania,-,881,832,640,3288,65,2145,7851,1001,980,843,4103,67,2229,9223,34820
2016,Algeria,-,84,50,43,426,12,728,1343,85,66,91,3075,29,1046,4392,10889
2016,Andorra,-,0,0,0,0,0,0,0,0,0,0,0,0,0,0,5
2016,Angola,-,1631,2697,1657,5518,535,2411,14449,1490,2517,1713,5659,855,3589,15823,33112
2016,"Antigua and Barbuda",-,0,0,0,8,0,0,8,0,0,0,9,0,0,9,112
2016,Egypt,-,267,395,233,1011,50,327,2283,234,419,384,3733,73,1139,5982,32929
2016,Argentina,-,0,0,0,11,0,13,24,0,0,0,13,5,0,18,339
2016,Armenia,-,454,476,324,3258,431,2262,7205,530,636,479,3407,346,2207,7605,23811
2016,Australia,-,0,0,0,0,0,0,0,0,5,0,0,0,0,5,25
2016,Austria,-,0,0,0,0,0,0,0,0,0,0,0,0,0,0,5
2016,Azerbaijan,-,462,520,244,2945,498,1652,6321,527,671,334,3371,313,1604,6820,631345
2016,Bahrain,-,5,20,10,14,0,0,49,0,6,5,97,0,5,113,579
2016,Barbados,-,0,0,0,17,0,0,17,0,0,0,18,0,0,18,188
2016,Burundi,-,38445,55763,47623,137261,10143,1804,291039,39159,56675,49234,143345,9373,2897,300683,737748
2016,Belgium,-,0,0,5,5,0,0,10,0,0,0,0,0,5,5,64
2016,Benin,-,12,0,13,78,0,70,173,7,5,45,502,0,125,684,1630
2016,Bangladesh,-,52,35,14,313,0,733,1147,52,43,66,4431,29,6804,11425,39786
2016,Bahamas,-,0,0,0,31,0,0,31,0,0,0,44,0,0,44,417
2016,Bhutan,-,476,793,681,2935,444,17,5346,509,853,651,3336,611,121,6081,12034
2016,"Burkina Faso",-,7,15,5,54,0,128,209,5,15,17,415,0,143,595,6547
2016,Belarus,-,39,38,23,240,8,282,630,33,51,31,284,17,360,776,5816
2016,"Bolivia (Plurinational State of)",-,8,18,12,41,5,37,121,0,20,0,80,8,38,146,941
2016,Botswana,-,0,6,0,11,0,0,17,0,0,0,16,0,0,16,392
2016,Brazil,-,0,5,13,43,0,7,68,0,0,19,62,0,10,91,4563
2016,"Brunei Darussalam",-,0,0,0,0,0,0,0,0,0,0,0,0,0,0,5
2016,"Bosnia and Herzegovina",-,205,355,383,3898,2179,76726,83746,243,356,444,4014,1325,79885,86267,172063
2016,Bulgaria,-,5,5,0,17,13,39,79,7,5,0,19,41,53,125,1057
2016,Belize,-,0,0,0,0,0,0,0,0,0,0,5,0,0,5,218
2016,Cambodia,-,15,9,16,134,0,5890,6064,18,19,17,145,10,6012,6221,12808
2016,Canada,-,0,8,0,5,0,0,13,0,5,0,5,0,0,10,130
2016,"Central African Rep.",-,40180,65772,39377,120598,7786,1110,274823,40286,64940,38965,92910,7650,1248,245999,934277
2016,"Cayman Islands",-,0,0,0,0,0,0,0,0,0,0,0,0,0,0,6
2016,Chad,-,15415,18108,11956,34973,4469,412,85333,16904,17081,10833,21822,2555,985,70180,158414
2016,China,-,179,207,134,3096,114,2928,6658,200,176,153,4129,127,4308,9093,279933
2016,Chile,-,0,0,5,71,36,63,175,0,0,0,77,76,70,223,695
2016,Cameroon,-,25388,23355,18233,31656,4066,851,103549,23710,22719,20751,29573,4929,1634,103316,220203
2016,Congo,-,1114,1389,2029,5122,789,4380,14823,957,1238,1439,3420,500,5170,12724,33039
2016,"Dem. Rep. of the Congo",-,267845,366107,185876,568632,53479,22294,1464233,271953,368340,194282,475133,33909,27566,1371183,2862556
2016,Comoros,-,0,7,0,0,0,197,204,0,5,0,6,0,355,366,798
2016,Colombia,-,119,312,537,2036,141,3636386,3639531,113,299,506,3205,187,3785581,3789891,7734456
2016,"Costa Rica",-,0,0,5,0,0,0,5,0,0,0,0,0,5,5,514
2016,Cuba,-,9,10,43,702,47,991,1802,12,31,48,1369,46,1793,3299,10965
2016,"Cabo Verde",-,0,0,0,0,0,29,29,0,5,0,0,0,52,57,108
2016,Cyprus,-,0,0,0,0,0,0,0,0,0,0,0,0,0,0,5
2016,Czechia,-,0,5,5,136,180,19,345,0,6,0,209,346,22,583,1499
2016,Denmark,-,0,0,0,0,0,0,0,0,0,0,0,0,0,0,5
2016,Djibouti,-,0,10,14,131,0,270,425,5,19,17,165,0,203,409,2268
2016,Dominica,-,0,0,0,0,0,0,0,0,0,0,0,0,0,0,146
2016,"Dominican Rep.",-,0,0,12,77,7,286,382,0,0,5,84,0,611,700,2713
2016,Ecuador,-,0,22,18,32,0,18,90,0,12,0,53,0,38,103,14723
2016,"Equatorial Guinea",-,0,0,0,11,0,15,26,0,0,0,26,10,14,50,231
2016,Eritrea,-,10099,19823,16711,73370,4611,9911,134525,10569,21105,22512,98349,5815,14918,173268,525014
2016,Estonia,-,0,0,0,0,0,8,8,0,0,0,0,0,0,0,345
2016,Ethiopia,-,5810,8131,5854,32070,834,5350,58049,6238,8379,6974,36004,954,17804,76353,163502
2016,Fiji,-,0,0,0,0,0,0,0,0,0,0,0,0,0,0,1301
2016,Finland,-,0,0,0,0,0,0,0,0,0,0,0,0,0,0,10
2016,France,-,0,0,0,0,0,8,8,0,5,0,22,5,6,38,166
2016,Gabon,-,0,0,0,27,0,33,60,0,0,5,26,0,44,75,598
2016,Gambia,-,88,59,30,443,0,166,786,80,43,372,9532,6,372,10405,30477
2016,Palestinian,-,6920,9511,6099,19018,1753,334,43635,7670,6121,11176,21277,1601,1228,49073,105973
2016,"United Kingdom of Great Britain and Northern Ireland",-,0,0,0,5,0,0,5,0,0,7,8,0,0,15,178
2016,Georgia,-,11641,13809,12175,78036,32882,1608,150151,12228,14930,13434,69964,21021,1568,133145,294317
2016,Germany,-,0,5,0,0,0,7,12,0,0,0,0,0,5,5,195
2016,Ghana,-,1337,1461,574,2935,296,1058,7661,1300,1578,632,3593,152,1583,8838,27373
2016,Guinea-Bissau,-,6,21,12,76,0,400,515,0,5,36,552,5,881,1479,3516
2016,Greece,-,0,0,6,0,7,0,13,0,8,0,12,26,0,46,177
2016,Grenada,-,0,0,0,7,0,0,7,0,0,0,0,0,0,0,163
2016,Guatemala,-,0,0,0,38,0,16,54,0,0,10,43,0,37,90,58771
2016,Guinea,-,186,107,92,834,10,5783,7012,159,97,650,4881,7,4187,9981,41925
2016,Guyana,-,0,0,0,6,0,5,11,0,0,0,17,0,20,37,565
2016,Haiti,-,6,120,128,7176,51,1569,9050,14,122,116,24410,74,1965,26701,75055
2016,"China, Hong Kong SAR",-,5,0,0,5,0,0,10,5,0,0,14,0,0,19,127
2016,Honduras,-,10005,12700,13739,48703,4300,1021,90468,11100,15912,12536,41752,3600,4062,88962,224507
2016,Croatia,-,0,143,739,7806,5528,52,14268,5,135,682,8047,2830,39,11738,41092
2016,Hungary,-,11,0,0,159,68,31,269,12,5,10,301,151,91,570,4575
2016,Iceland,-,0,0,0,0,0,0,0,0,0,0,0,0,0,0,5
2016,"Cote d'Ivoire",-,2325,3896,2491,9132,521,1602,19967,2364,3909,2559,11079,409,1673,21993,65456
2016,India,-,94,102,53,1028,14,344,1635,125,113,101,3420,29,1588,5376,35491
2016,Indonesia,-,62,18,21,421,5,5,532,70,27,20,192,14,0,323,16637
2016,Ireland,-,0,0,0,0,0,0,0,0,0,0,0,0,0,0,42
2016,"Iran (Islamic Rep. of)",-,1940,3481,2718,28542,1885,2197,40763,2060,3050,3712,51981,2455,4866,68124,181910
2016,Iraq,-,18963,31132,20092,99500,10013,5188,184888,20213,33886,25793,150966,9471,8568,248897,4214486
2016,Israel,-,0,7,5,27,5,15,59,0,0,15,59,0,18,92,1035
2016,Italy,-,0,9,0,15,0,6,30,5,7,0,8,0,5,25,181
2016,Jamaica,-,0,7,0,79,0,5,91,5,5,0,139,0,14,163,3132
2016,Jordan,-,34,89,14,453,15,66,671,21,33,61,360,6,87,568,4483
2016,Japan,-,0,11,5,5,0,0,21,0,6,5,5,0,0,16,136
2016,Kazakhstan,-,20,40,12,214,38,317,641,23,43,23,478,5,262,834,4591
2016,Kenya,-,354,422,388,1295,170,209,2838,413,476,367,941,130,225,2552,11102
2016,Kyrgyzstan,-,36,55,40,246,16,187,580,38,75,42,272,5,201,633,4939
2016,"Rep. of Korea",-,0,6,6,25,0,0,37,5,0,10,36,0,14,65,509
2016,"Dem. People's Rep. of Korea",-,11,6,0,80,11,25,133,5,5,5,112,5,23,155,1945
2016,Kuwait,-,5,0,32,31,0,54,122,0,8,8,67,0,136,219,1663
2016,"Lao People's Dem. Rep.",-,0,0,0,0,9,3301,3310,0,0,0,40,6,3686,3732,7396
2016,Liberia,-,184,224,293,1476,54,106,2337,144,234,284,2044,42,229,2977,9268
2016,Libya,-,152,203,113,635,5,194,1302,163,251,159,1995,26,419,3013,189872
2016,"Saint Lucia",-,0,0,9,7,0,0,16,0,0,6,23,0,0,29,1189
2016,Lebanon,-,268,291,213,1384,103,313,2572,299,409,283,3009,59,953,5012,13203
2016,Lesotho,-,0,0,0,5,0,148,153,0,0,0,0,0,68,68,703
2016,"Sri Lanka",-,440,343,222,2374,406,41140,44925,415,365,319,7313,285,50677,59374,172676
2016,Lithuania,-,0,0,0,5,0,0,5,0,0,0,0,0,19,19,152
2016,Latvia,-,0,5,0,0,0,19,24,0,0,0,19,0,19,38,261
2016,"China, Macao SAR",-,0,0,0,0,0,0,0,0,0,0,0,0,0,0,5
2016,Madagascar,-,0,5,0,16,0,111,132,0,0,0,5,0,114,119,350
2016,Mauritania,-,2673,3698,2093,5769,464,1271,15968,2767,3755,2058,5593,569,4135,18877,43654
2016,"North Macedonia",-,467,517,428,1825,65,231,3533,521,601,433,1861,86,261,3763,8784
2016,Monaco,-,0,0,0,0,0,0,0,0,0,0,0,0,0,0,5
2016,"Rep. of Moldova",-,165,196,103,699,28,172,1363,185,198,125,563,25,182,1278,6670
2016,Maldives,-,0,5,0,0,0,0,5,0,0,0,8,0,0,8,93
2016,Mexico,-,0,0,11,68,0,20,99,0,0,11,97,0,38,146,74643
2016,"Marshall Islands",-,0,0,0,0,0,0,0,0,0,0,0,0,0,0,5
2016,Mali,-,9840,15493,18603,27838,2932,3394,78100,10036,15216,13458,25427,2788,1220,68145,202830
2016,Malaysia,-,5,7,7,11,0,12,42,0,0,9,10,0,0,19,6616
2016,Malawi,-,13,15,5,92,0,894,1019,9,10,5,93,0,2502,2619,4179
2016,Mongolia,-,140,76,31,479,18,249,993,123,109,38,413,9,165,857,6113
2016,Morocco,-,61,33,27,622,7,162,912,61,29,124,2255,7,570,3046,9500
2016,Mozambique,-,467,533,265,809,63,707,2844,468,532,303,714,56,800,2873,20878
2016,Montenegro,-,95,95,75,346,24,67,702,93,104,74,308,16,64,659,1845
2016,Mauritius,-,5,0,7,21,0,5,38,0,0,5,18,0,5,28,309
2016,Myanmar,-,31359,29274,26402,98945,8321,56,194357,31823,30681,28140,139986,7266,303,238199,921585
2016,Namibia,-,33,76,50,138,0,5,302,33,82,46,511,30,16,718,1534
2016,Nepal,-,5,0,7,721,12,90,835,9,0,22,502,0,238,771,20480
2016,"Netherlands (Kingdom of the)",-,0,0,0,9,0,0,9,5,0,0,5,0,0,10,74
2016,Niger,-,13181,17918,7179,27171,1976,55,67480,15088,20192,7802,23015,3321,102,69520,138137
2016,Nicaragua,-,18,15,18,283,24,205,563,25,14,21,612,12,302,986,3534
2016,Nigeria,-,20530,24185,10357,42278,2771,1802,101923,21800,25157,11077,40930,4407,5824,109195,2515440
2016,Niue,-,0,0,0,0,0,0,0,0,0,0,0,0,0,0,19
2016,Norway,-,0,0,0,0,0,0,0,0,0,0,0,0,0,0,25
2016,"New Zealand",-,0,0,0,0,0,0,0,0,0,0,8,0,0,8,43
2016,Oman,-,0,0,0,5,0,0,5,0,0,5,0,0,0,5,59
2016,Pakistan,-,42370,62118,25278,106355,10000,455,246576,51614,72832,37165,132634,10533,4683,309461,622075
2016,Panama,-,0,0,0,0,0,5,5,0,0,0,0,0,0,0,114
2016,Paraguay,-,5,0,0,18,0,6,29,0,0,0,13,0,23,36,185
2016,Peru,-,0,0,5,295,65,141,506,0,5,13,321,68,189,596,4889
2016,Philippines,-,10,10,11,243,5,43783,44062,0,5,12,187,0,43721,43925,171016
2016,"Papua New Guinea",-,0,0,0,0,0,0,0,0,0,0,0,0,0,0,662
2016,Poland,-,8,0,7,78,109,123,325,0,0,12,185,317,184,698,1724
2016,Portugal,-,0,0,0,0,0,10,10,5,0,0,6,5,12,28,101
2016,Qatar,-,0,0,0,0,0,0,0,0,0,0,0,0,0,0,48
2016,Romania,-,5,0,11,103,34,93,246,0,5,7,113,90,122,337,3715
2016,"South Africa",-,11,19,18,127,0,65,240,13,22,10,162,8,292,507,1534
2016,"Russian Federation",-,1977,2686,1332,6922,492,9492,22901,2170,2878,1525,6687,301,8915,22476,98125
2016,Rwanda,-,29571,37806,26169,51345,2754,2614,150259,26120,38766,27472,50626,3551,2600,149135,303758
2016,"El Salvador",-,39,71,129,602,62,4185,5088,49,69,182,719,74,7076,8169,91580
2016,"Saudi Arabia",-,20,27,7,93,0,13,160,11,36,0,89,0,11,147,1933
2016,"Serbia and Kosovo: S/RES/1244 (1999)",-,2385,10619,14037,73715,23987,6881,131624,2529,11216,14981,76574,19755,7614,132669,278260
2016,Senegal,-,1059,1831,1112,4131,543,927,9603,1019,1889,1174,6243,520,5901,16746,39355
2016,Seychelles,-,0,0,0,0,0,0,0,0,0,0,0,0,0,0,15
2016,Singapore,-,0,0,0,0,0,0,0,0,5,0,0,0,0,5,85
2016,"Sierra Leone",-,89,87,100,651,5,247,1179,50,83,143,1947,20,2006,4249,10831
2016,"Solomon Islands",-,0,0,0,0,0,0,0,0,5,0,0,0,0,5,150
2016,Somalia,-,243525,283658,146618,461213,38587,8103,1181704,305944,330505,183689,467720,35858,28881,1352597,2635655
2016,Spain,-,5,11,0,10,0,11,37,0,8,5,5,8,15,41,154
2016,"Viet Nam",-,76,95,70,810,180,4039,5270,108,91,109,1373,199,5080,6960,333947
2016,"Saint Kitts and Nevis",-,0,0,0,0,0,0,0,0,0,0,0,0,0,0,71
2016,"Sao Tome and Principe",-,0,5,0,10,0,8,23,0,5,0,6,0,5,16,39
2016,Sudan,-,58533,80621,50878,143338,11939,833,346142,60490,81370,50121,111932,9626,6807,320346,2926542
2016,Suriname,-,0,0,0,0,0,0,0,0,0,0,0,0,5,5,41
2016,"South Sudan",-,95770,140715,86487,198217,15694,1078268,1615151,97441,146243,96456,118332,6024,1013041,1477537,3296423
2016,Slovakia,-,0,0,0,40,17,59,116,0,0,0,152,34,56,242,1372
2016,Slovenia,-,0,0,0,0,0,0,0,0,0,0,0,7,0,7,32
2016,Eswatini,-,0,0,0,11,0,0,11,0,0,0,9,0,5,14,361
2016,Sweden,-,0,0,0,5,0,0,5,0,0,0,0,0,0,0,30
2016,Switzerland,-,0,0,0,0,0,0,0,0,0,0,0,0,0,0,15
2016,"Syrian Arab Rep.",-,166460,230191,133946,527722,36580,9878,1104777,175472,245732,156112,608570,29826,16539,1232251,12043342
2016,"United Rep. of Tanzania",-,20,20,16,103,0,103,262,17,28,9,206,0,551,811,1804
2016,"Turks and Caicos Islands",-,0,0,0,0,0,0,0,0,0,0,0,0,0,0,19
2016,Thailand,-,0,5,5,120,0,0,130,0,10,5,33,5,29,82,1097
2016,Tajikistan,-,190,197,71,546,14,35,1053,195,182,129,1109,10,37,1662,4130
2016,Turkmenistan,-,35,49,13,481,14,17,609,44,43,19,239,8,20,373,1440
2016,Timor-Leste,-,0,0,0,0,0,0,0,0,0,0,0,0,0,0,19
2016,Togo,-,156,341,288,1375,82,676,2918,157,362,257,2769,119,1115,4779,10941
2016,Tonga,-,0,0,0,0,0,0,0,0,0,0,0,0,0,0,102
2016,"Trinidad and Tobago",-,0,0,0,5,0,0,5,6,0,0,10,0,0,16,542
2016,Tunisia,-,28,29,21,223,0,204,505,37,15,50,822,5,441,1370,3756
2016,Türkiye,-,857,1929,2121,13540,2538,4227,25212,1002,771,2414,21423,2227,11325,39162,81196
2016,"United Arab Emirates",-,0,5,5,5,0,0,15,5,13,0,7,0,0,25,263
2016,Uganda,-,18142,18205,18129,19300,18023,466,92265,18149,18185,18150,19373,18042,1121,93020,191557
2016,Ukraine,-,401,520,287,2762,352,911,5233,476,559,327,2646,151,786,4945,2073705
2016,Uruguay,-,5,0,0,0,0,6,11,0,0,0,0,0,0,0,126
2016,"United States of America",-,15,26,47,34,6,10,138,10,33,36,53,10,14,156,595
2016,Uzbekistan,-,45,70,54,491,17,190,867,41,61,95,324,5,172,698,6911
2016,"Saint Vincent and the Grenadines",-,0,7,15,23,0,0,45,0,6,6,23,0,0,35,1466
2016,"Venezuela (Bolivarian Republic of)",-,56,59,71,472,5,1988,2651,64,84,37,756,16,3885,4842,52617
2016,Samoa,-,0,0,0,0,0,0,0,0,0,0,0,0,0,0,10
2016,"Western Sahara",-,0,0,0,23,0,44119,44142,0,0,0,151,0,46309,46460,118641
2016,Yemen,-,81536,273525,172361,458977,30655,154,1017208,82718,287697,205558,419956,41352,239,1037520,2059362
2016,Zambia,-,0,0,0,10,0,163,173,0,0,0,10,0,84,94,550
2016,Zimbabwe,-,96,133,73,672,13,19612,20599,96,113,81,677,17,15639,16623,61493
2016,Stateless,-,368,611,422,2213,126,522,4262,390,765,666,5164,218,814,8017,59432
2016,Tibetan,-,0,0,0,7003,0,0,7003,0,0,0,6511,0,5,6516,13546
2016,"Curacao ",-,0,0,0,0,0,0,0,0,0,0,0,0,0,0,35
2016,"Unknown ",-,2066,2633,1858,8919,725,14621,30822,2242,3027,3000,19957,1255,30574,60055,396467
2017,Afghanistan,-,343402,395696,306373,789832,73335,3213,1911851,352084,426375,345197,974417,96488,17075,2211636,5243370
2017,Albania,-,414,469,325,1834,44,2247,5333,472,516,480,2060,57,2154,5739,30929
2017,Algeria,-,84,57,44,452,8,782,1427,82,94,77,2354,33,1149,3789,10460
2017,Andorra,-,0,0,0,0,0,0,0,0,0,0,0,0,0,0,5
2017,Angola,-,1613,2349,1447,4813,490,1533,12245,1561,2245,1532,4083,843,2001,12265,33840
2017,"Antigua and Barbuda",-,0,0,0,0,0,0,0,0,0,0,0,0,0,0,162
2017,Egypt,-,327,484,297,1217,39,309,2673,298,479,361,3715,74,798,5725,36735
2017,Argentina,-,0,0,0,6,0,10,16,0,0,0,0,8,0,8,473
2017,Armenia,-,541,588,397,3577,501,2246,7850,604,743,599,3646,389,2150,8131,25701
2017,Australia,-,0,0,0,0,0,0,0,0,0,5,0,0,0,5,20
2017,Austria,-,0,5,0,0,0,0,5,0,0,0,0,0,0,0,36
2017,Azerbaijan,-,567,679,310,3293,526,1635,7010,664,819,457,3672,324,1579,7515,633219
2017,Bahrain,-,5,15,17,22,0,0,59,5,5,5,109,0,11,135,669
2017,Barbados,-,0,0,0,0,0,0,0,0,0,0,0,0,0,0,248
2017,Burundi,-,44478,63495,48381,153881,42902,3632,356769,43912,63332,48762,159353,10297,32772,358428,721216
2017,Belgium,-,0,0,0,6,0,0,6,0,0,0,0,0,0,0,89
2017,Benin,-,20,0,0,86,0,26,132,11,5,26,267,0,18,327,1709
2017,Bangladesh,-,70,60,20,275,5,989,1419,56,51,45,3742,18,30918,34830,84913
2017,Bahamas,-,0,0,0,0,0,0,0,0,0,0,0,0,0,0,613
2017,Bhutan,-,266,502,415,1898,345,18,3444,312,547,415,2290,478,99,4141,8354
2017,"Burkina Faso",-,284,341,154,562,17,113,1471,254,304,181,611,22,90,1462,10601
2017,Belarus,-,25,45,18,218,12,289,607,28,50,32,210,18,331,669,6512
2017,"Bolivia (Plurinational State of)",-,0,0,12,19,0,17,48,0,0,0,24,8,19,51,1385
2017,Botswana,-,0,0,0,18,0,0,18,0,5,0,0,0,0,5,374
2017,Brazil,-,0,23,15,31,0,12,81,0,0,22,60,0,5,87,7637
2017,"Brunei Darussalam",-,0,0,0,0,0,0,0,0,0,0,0,0,0,0,9
2017,"Bosnia and Herzegovina",-,103,194,296,3441,2107,75012,81153,104,245,349,3613,1289,78145,83745,167057
2017,Bulgaria,-,7,0,6,23,13,27,76,0,13,0,14,38,49,114,1032
2017,Belize,-,0,0,0,0,0,0,0,0,0,0,0,0,0,0,270
2017,Cambodia,-,14,24,24,151,5,5823,6041,12,20,29,164,10,5860,6095,13816
2017,Canada,-,0,8,0,5,0,5,18,5,5,6,5,0,0,21,153
2017,"Central African Rep.",-,55518,68973,49485,120425,8635,1269,304305,55834,68287,44476,96047,7843,1463,273950,1268642
2017,"Cayman Islands",-,0,0,0,0,0,0,0,0,0,0,0,0,0,0,6
2017,Chad,-,13819,18410,8125,28333,2470,11414,82571,13698,18316,8314,17420,2133,11589,71470,156730
2017,China,-,189,178,122,2518,86,2452,5545,230,200,108,3609,117,3078,7342,297224
2017,Chile,-,0,6,0,62,38,46,152,0,0,0,46,75,33,154,843
2017,Cameroon,-,810,711,2257,2102,344,109810,116034,800,487,1609,3942,171,115155,122164,257358
2017,Congo,-,125,140,153,649,13,76507,77587,99,195,155,1003,56,48894,50402,134281
2017,"Dem. Rep. of the Congo",-,522233,659023,366971,978617,131665,35922,2694431,524957,509462,379062,822296,102044,58243,2396064,5118888
2017,Comoros,-,0,0,7,0,0,207,214,0,5,0,6,0,368,379,922
2017,Colombia,-,443,1368,2242,13804,1024,4072494,4091375,436,1400,2319,15168,1315,3612632,3633270,7901722
2017,"Costa Rica",-,0,0,5,0,0,0,5,0,0,0,0,0,0,0,681
2017,Cuba,-,28,26,70,1469,59,328,1980,25,47,52,3415,72,633,4244,18589
2017,"Cabo Verde",-,0,0,0,0,0,0,0,0,0,0,0,0,0,0,186
2017,Cyprus,-,0,0,0,0,0,0,0,0,0,0,0,0,0,0,20
2017,Czechia,-,0,0,0,93,195,11,299,0,0,0,143,346,23,512,1579
2017,Denmark,-,0,0,0,0,0,0,0,0,0,0,0,0,0,0,21
2017,Djibouti,-,5,18,13,48,10,169,263,0,14,8,69,0,101,192,3047
2017,Dominica,-,0,0,0,0,0,0,0,0,0,0,0,0,0,0,89
2017,"Dominican Rep.",-,0,5,5,173,6,39,228,0,0,0,102,0,10,112,3586
2017,Ecuador,-,0,21,19,19,0,12,71,5,6,0,28,0,23,62,18592
2017,"Equatorial Guinea",-,0,0,0,10,0,17,27,0,0,0,20,5,15,40,237
2017,Eritrea,-,13841,22211,27439,88130,5031,14632,171284,14263,23403,30907,156059,6273,15755,246660,564662
2017,Estonia,-,0,0,0,0,0,7,7,0,0,5,0,0,0,5,330
2017,Ethiopia,-,6456,9091,6521,35693,1078,8712,67551,6840,9576,7674,40888,1396,60231,126605,1303794
2017,"French Guiana",-,0,0,0,0,0,0,0,0,0,0,0,0,0,0,11
2017,Fiji,-,0,0,0,0,0,0,0,0,0,0,0,0,0,0,1412
2017,Finland,-,0,0,0,0,0,0,0,0,0,0,0,0,0,0,15
2017,France,-,0,0,0,0,0,0,0,0,5,0,14,6,0,25,194
2017,Gabon,-,5,0,0,15,0,41,61,0,9,0,36,0,41,86,912
2017,Gambia,-,106,47,38,492,0,178,861,92,56,221,8930,6,181,9486,36778
2017,Palestinian,-,6827,9523,6215,19115,1851,331,43862,7521,6682,11259,21205,1768,599,49034,110150
2017,"United Kingdom of Great Britain and Northern Ireland",-,0,0,0,6,0,0,6,6,0,5,6,0,0,17,243
2017,Georgia,-,11722,16383,10516,80240,31892,1628,152381,12219,17618,11710,71731,20152,1599,135029,301104
2017,Germany,-,0,0,0,0,0,11,11,0,0,0,0,0,0,0,245
2017,Ghana,-,1322,1471,573,2811,295,1535,8007,1255,1573,608,2779,161,1682,8058,34463
2017,Guinea-Bissau,-,11,11,18,81,0,304,425,12,0,27,415,5,875,1334,5372
2017,Greece,-,0,0,0,6,0,0,6,0,0,0,13,29,0,42,201
2017,Grenada,-,0,0,0,0,0,0,0,0,0,0,0,0,0,0,165
2017,Guatemala,-,0,0,5,11,0,24,40,0,0,6,39,0,35,80,89010
2017,Guinea,-,225,158,79,952,6,4656,6076,205,109,856,6272,16,12548,20006,54851
2017,Guyana,-,0,0,0,5,0,5,10,0,0,0,5,0,11,16,742
2017,Haiti,-,11,104,112,628,37,1609,2501,21,110,103,748,60,1972,3014,109313
2017,"China, Hong Kong SAR",-,0,0,0,0,0,0,0,0,0,0,0,0,0,0,115
2017,Honduras,-,10005,12708,13721,48694,4300,696,90124,11100,15900,12528,41696,3600,2994,87818,251406
2017,Croatia,-,0,131,693,7410,5230,41,13505,0,121,638,7610,2675,44,11088,33156
2017,Hungary,-,0,0,0,25,68,32,125,0,5,0,41,137,40,223,4997
2017,Iceland,-,0,0,0,5,0,0,5,0,0,0,0,0,0,0,5
2017,"Cote d'Ivoire",-,1736,2705,1963,7462,408,1836,16110,1777,2739,2056,9787,311,8025,24695,66564
2017,India,-,89,81,50,726,12,809,1767,80,88,98,2071,19,3901,6257,48517
2017,Indonesia,-,9,0,5,59,0,11,84,0,5,5,0,7,5,22,17869
2017,Ireland,-,0,0,0,0,0,0,0,0,0,0,0,0,0,0,52
2017,"Iran (Islamic Rep. of)",-,2275,3828,3026,31124,1980,1853,44086,2353,4203,3756,54479,2898,2593,70282,196447
2017,Iraq,-,22103,37786,24152,112873,11656,5267,213837,23332,41131,29265,162680,11137,6613,274158,3262378
2017,Israel,-,0,12,0,21,5,12,50,0,0,17,26,0,5,48,1160
2017,Italy,-,12,11,0,10,0,0,33,0,6,5,11,0,5,27,334
2017,Jamaica,-,0,0,0,26,0,5,31,0,0,0,134,0,9,143,3654
2017,Jordan,-,40,62,28,439,14,28,611,43,50,81,351,9,53,587,5646
2017,Japan,-,0,7,5,5,0,0,17,0,6,0,5,0,0,11,143
2017,Kazakhstan,-,23,37,16,400,35,309,820,35,33,42,981,5,255,1351,5920
2017,Kenya,-,431,406,364,1318,170,624,3313,499,436,333,908,126,758,3060,13293
2017,Kyrgyzstan,-,48,56,48,232,16,159,559,33,109,31,286,0,177,636,5341
2017,"Rep. of Korea",-,0,0,6,20,0,0,26,0,0,9,23,0,0,32,620
2017,"Dem. People's Rep. of Korea",-,7,5,5,57,5,0,79,5,0,8,78,7,0,98,1763
2017,Kuwait,-,10,28,36,77,0,5,156,8,46,31,81,0,72,238,2053
2017,"Lao People's Dem. Rep.",-,0,0,0,0,8,3256,3264,0,0,0,42,6,3592,3640,7279
2017,Liberia,-,171,207,332,1417,57,102,2286,163,262,278,1911,41,848,3503,9546
2017,Libya,-,216,274,137,766,9,291,1693,202,322,149,2080,31,565,3349,198989
2017,"Saint Lucia",-,0,0,0,0,0,0,0,0,0,0,0,0,0,0,1173
2017,Lebanon,-,314,388,264,1441,107,52,2566,329,429,314,2276,61,136,3545,14586
2017,Lesotho,-,0,0,0,0,0,0,0,0,0,0,0,0,0,0,26
2017,"Sri Lanka",-,268,334,211,2268,418,41487,44986,233,331,263,7348,304,48687,57166,173894
2017,Lithuania,-,0,0,5,0,0,0,5,0,0,0,0,0,11,11,168
2017,Latvia,-,5,0,0,5,0,19,29,0,0,6,12,0,19,37,267
2017,"China, Macao SAR",-,0,0,0,0,0,0,0,0,0,0,0,0,0,0,10
2017,Madagascar,-,0,0,0,15,0,110,125,0,0,0,0,0,111,111,370
2017,Mauritania,-,2016,3756,2360,5999,568,1258,15957,2099,3855,2290,5846,690,9776,24556,44073
2017,"North Macedonia",-,212,321,249,1014,46,173,2015,255,337,250,984,50,186,2062,5691
2017,Monaco,-,0,0,0,0,0,0,0,0,0,0,0,0,0,0,5
2017,"Rep. of Moldova",-,44,44,30,225,7,205,555,30,44,35,185,10,194,498,5757
2017,Maldives,-,0,5,0,0,0,0,5,0,0,0,8,5,0,13,98
2017,Mexico,-,0,0,0,31,0,21,52,0,0,6,23,0,18,47,96757
2017,"Marshall Islands",-,0,0,0,0,0,0,0,0,0,0,0,0,0,0,7
2017,Mali,-,12707,17872,9628,28612,2391,3670,74880,12781,17868,9611,19014,2364,1091,62729,203929
2017,Malaysia,-,11,5,8,94,0,9,127,8,0,6,376,0,0,390,10018
2017,Malawi,-,19,5,5,90,0,612,731,20,5,5,89,0,2149,2268,3588
2017,Mongolia,-,134,116,40,519,14,251,1074,117,114,40,416,10,176,873,6401
2017,Morocco,-,106,53,40,683,12,154,1048,97,39,102,1653,15,537,2443,9957
2017,Mozambique,-,470,653,371,896,79,3719,6188,509,659,395,827,98,3823,6311,27757
2017,Malta,-,0,0,0,0,0,0,0,0,0,0,0,0,0,0,5
2017,Montenegro,-,28,53,52,232,23,53,441,53,60,59,196,16,38,422,1474
2017,Mauritius,-,0,5,5,21,0,11,42,0,5,0,25,0,5,35,359
2017,Myanmar,-,106093,117484,79501,287563,22696,57,613394,108889,124145,82418,283302,20273,283,619310,1551047
2017,Namibia,-,30,56,53,126,0,0,265,29,62,62,491,35,0,679,1584
2017,Nepal,-,0,10,0,480,0,94,584,6,0,15,303,0,151,475,21983
2017,"Netherlands (Kingdom of the)",-,5,0,0,6,0,0,11,10,0,0,5,0,0,15,103
2017,Niger,-,14342,24733,8076,27711,3164,98,78124,12144,19276,6183,18564,4809,867,61843,147597
2017,Nicaragua,-,29,17,20,225,24,264,579,28,19,171,289,7,370,884,4189
2017,Nigeria,-,20490,26583,11234,46288,2859,2904,110358,20120,24065,10751,41597,3380,8307,108220,2035005
2017,Niue,-,0,0,0,0,0,0,0,0,0,0,0,0,0,0,24
2017,Norway,-,0,0,0,0,0,0,0,0,5,0,0,0,0,5,40
2017,"New Zealand",-,0,0,0,0,0,0,0,0,0,0,8,0,0,8,61
2017,Oman,-,0,0,6,0,0,0,6,9,0,0,0,0,0,9,61
2017,Pakistan,-,21375,33994,12304,49788,4594,602,122657,25216,41659,19741,74492,7037,11077,179222,380153
2017,Panama,-,0,0,0,0,0,5,5,0,0,0,0,0,5,5,162
2017,Paraguay,-,0,0,0,13,0,6,19,0,0,0,10,0,0,10,252
2017,Peru,-,5,0,0,311,65,145,526,0,0,24,329,75,176,604,6085
2017,Philippines,-,13,5,5,301,5,159092,159421,5,10,5,124,0,152851,152995,400518
2017,Palau,-,0,0,0,0,0,0,0,0,0,0,0,0,0,0,5
2017,"Papua New Guinea",-,0,0,0,0,0,0,0,0,0,0,0,0,0,0,778
2017,Poland,-,0,0,5,67,113,70,255,0,0,7,157,317,75,556,1907
2017,Portugal,-,6,5,0,0,0,0,11,0,0,0,0,0,5,5,187
2017,Qatar,-,0,0,0,0,0,0,0,0,0,0,0,0,0,0,70
2017,Romania,-,5,0,5,41,34,71,156,0,5,9,47,85,95,241,4466
2017,"South Africa",-,16,42,16,135,5,9,223,20,34,15,191,12,23,295,2074
2017,"Russian Federation",-,1866,2919,1531,7368,545,8688,22917,2084,3175,1714,7054,338,7956,22321,100247
2017,Rwanda,-,26100,33990,23393,47611,2680,2490,136264,22797,34997,24862,47812,3589,2990,137047,278464
2017,"El Salvador",-,40,55,101,722,43,40696,41657,61,69,111,800,66,37964,39071,206477
2017,"Saudi Arabia",-,27,23,10,105,0,7,172,6,24,15,66,0,10,121,2475
2017,"Serbia and Kosovo: S/RES/1244 (1999)",-,1650,9678,13232,70666,23727,6718,125671,1765,10259,14093,72796,19519,7315,125747,263506
2017,Senegal,-,919,1969,1327,4476,618,817,10126,886,1864,1415,5099,520,1150,10934,51765
2017,Seychelles,-,0,0,0,0,0,0,0,0,0,0,0,0,0,0,15
2017,Singapore,-,0,0,0,0,0,0,0,0,7,0,0,0,0,7,103
2017,"Sierra Leone",-,99,138,199,613,6,220,1275,84,95,254,1890,22,2244,4589,11106
2017,"Solomon Islands",-,0,0,0,8,0,0,8,0,0,0,0,0,0,0,163
2017,Somalia,-,229769,388150,193709,585515,93500,8040,1498683,233775,405552,214792,575280,106032,29648,1565079,3161641
2017,Spain,-,0,22,10,0,0,6,38,6,12,5,5,6,0,34,236
2017,"Viet Nam",-,62,101,80,615,184,4085,5127,77,99,87,1121,219,4893,6496,341247
2017,"Saint Kitts and Nevis",-,0,0,0,0,0,0,0,0,0,0,0,0,0,0,69
2017,"Sao Tome and Principe",-,0,5,0,10,0,5,20,0,5,0,6,0,0,11,54
2017,Sudan,-,58388,77464,90368,127027,12517,1045,366809,60416,76932,64659,121228,10547,12723,346505,2743788
2017,Suriname,-,0,7,0,0,0,0,7,0,0,0,0,0,0,0,61
2017,"South Sudan",-,162041,251757,153685,364739,30760,1009579,1972561,163656,263088,170340,252475,15323,990180,1855062,4360293
2017,Slovakia,-,0,0,0,14,16,59,89,0,0,0,21,34,57,112,1612
2017,Slovenia,-,0,0,0,0,0,0,0,0,0,0,0,7,0,7,31
2017,Eswatini,-,0,0,0,16,0,0,16,0,0,0,17,0,0,17,271
2017,Sweden,-,6,0,0,0,0,0,6,0,0,0,0,0,0,0,32
2017,Switzerland,-,0,0,0,0,0,0,0,0,0,0,0,0,0,0,15
2017,"Syrian Arab Rep.",-,190650,264241,152233,604450,41122,9962,1262658,201410,281579,174037,714775,34196,11038,1417035,12616278
2017,"United Rep. of Tanzania",-,22,25,26,95,0,20,188,18,25,9,179,0,30,261,2125
2017,"Turks and Caicos Islands",-,0,0,0,0,0,0,0,0,0,0,0,0,0,0,19
2017,Thailand,-,5,5,5,249,0,0,264,0,0,0,73,5,6,84,1497
2017,Tajikistan,-,263,281,96,667,13,34,1354,275,269,162,1290,13,60,2069,4986
2017,Turkmenistan,-,27,27,30,513,5,12,614,21,40,9,231,0,19,320,1480
2017,Timor-Leste,-,0,0,0,0,0,0,0,0,0,0,0,0,0,0,18
2017,Togo,-,168,360,277,1403,92,543,2843,159,367,277,2829,133,766,4531,11877
2017,Tonga,-,0,0,0,0,0,0,0,0,0,0,0,0,0,0,140
2017,"Trinidad and Tobago",-,9,0,0,0,0,0,9,6,0,0,0,0,18,24,628
2017,Tunisia,-,28,34,21,219,6,256,564,30,30,18,613,16,317,1024,4163
2017,Türkiye,-,1270,2299,2266,14981,2568,5093,28477,1396,2383,2521,23846,2299,9032,41477,95194
2017,"United Arab Emirates",-,7,0,5,5,0,0,17,0,18,0,29,0,0,47,344
2017,Uganda,-,167,259,192,1204,18,91451,93291,195,214,216,1413,35,93904,95977,196565
2017,Ukraine,-,275,405,224,1925,274,1170919,1174022,321,440,232,1701,115,631021,633830,1977256
2017,Uruguay,-,0,0,0,0,0,0,0,0,0,0,0,0,0,0,186
2017,"United States of America",-,5,11,31,31,7,6,91,5,23,27,46,9,9,119,2512
2017,Uzbekistan,-,26,109,56,429,14,165,799,48,90,94,299,7,162,700,6946
2017,Vanuatu,-,0,0,0,0,0,0,0,0,0,0,0,0,0,0,14
2017,"Saint Vincent and the Grenadines",-,0,0,5,0,0,0,5,0,5,0,0,0,0,5,1447
2017,"Venezuela (Bolivarian Republic of)",-,926,986,573,13042,173,1620,17320,980,999,569,21223,132,2354,26257,502953
2017,Samoa,-,0,0,0,0,0,0,0,0,0,0,0,0,0,0,11
2017,"Western Sahara",-,0,0,0,26,0,44152,44178,0,0,0,160,0,46981,47141,118605
2017,Yemen,-,81579,271974,162341,458545,40341,214,1014994,82753,204745,288432,433327,31159,304,1040720,2062256
2017,Zambia,-,0,5,0,27,0,44,76,0,0,0,5,0,32,37,429
2017,Zimbabwe,-,115,186,90,882,13,12532,13818,115,200,106,754,11,11372,12558,39349
2017,Stateless,-,450,692,463,2521,135,355,4616,414,852,689,5396,229,248,7828,62242
2017,Tibetan,-,0,0,0,7003,0,0,7003,0,0,0,6514,0,0,6514,13551
2017,Guadeloupe,-,0,0,0,0,0,0,0,0,0,0,0,0,0,0,37
2017,"Curacao ",-,0,0,0,0,0,0,0,0,0,0,0,0,0,0,35
2017,"Unknown ",-,2427,2443,1624,8514,485,40082,55575,2580,2783,2381,18535,618,80902,107799,357115
2018,Afghanistan,-,359530,443869,332062,871802,85113,2917,2095293,363797,471951,362078,1045452,109334,18033,2370645,5588126
2018,Albania,-,293,287,351,1549,73,2663,5216,334,379,366,1895,50,2496,5520,34583
2018,Algeria,-,102,41,64,458,17,859,1541,89,98,68,1864,41,1017,3177,11639
2018,Angola,-,1477,2388,1539,4934,518,1569,12425,1407,2322,1602,4162,901,2022,12416,35167
2018,"Antigua and Barbuda",-,0,5,0,7,0,0,12,0,0,0,5,0,0,5,154
2018,Egypt,-,334,479,440,1453,95,310,3111,364,560,377,4223,97,794,6415,41657
2018,Argentina,-,5,0,0,17,0,5,27,6,5,0,11,8,0,30,601
2018,Armenia,-,521,386,478,3003,586,2147,7121,493,650,516,3249,401,2065,7374,24742
2018,Australia,-,0,0,0,0,0,0,0,0,0,5,0,0,0,5,27
2018,Austria,-,0,5,0,5,0,0,10,0,0,0,0,0,0,0,34
2018,Azerbaijan,-,558,440,606,3321,667,1525,7117,624,844,457,3684,410,1446,7465,640987
2018,Bahrain,-,5,16,33,18,0,0,72,7,6,5,85,0,10,113,676
2018,Barbados,-,0,0,5,6,0,0,11,0,0,0,10,0,0,10,292
2018,Burundi,-,43222,48787,34634,96009,6014,417,229083,43465,49448,34199,110416,5469,503,243500,487267
2018,Belgium,-,0,0,0,5,0,0,5,0,0,0,0,0,0,0,129
2018,Benin,-,14,5,13,96,0,33,161,17,5,13,255,0,28,318,1743
2018,Bangladesh,-,85,83,55,385,5,886,1499,52,74,69,3448,24,4792,8459,79873
2018,Bahamas,-,0,0,0,8,0,0,8,0,0,0,23,0,0,23,812
2018,Bhutan,-,241,435,381,1721,307,21,3106,257,456,404,2021,445,102,3685,7490
2018,"Burkina Faso",-,5166,7258,3744,11330,1039,150,28687,5166,7769,4229,9083,1124,91,27462,63426
2018,Belarus,-,27,34,33,195,14,252,555,28,39,11,217,20,290,605,6808
2018,"Bolivia (Plurinational State of)",-,0,14,5,22,0,18,59,6,0,0,37,0,20,63,1506
2018,Botswana,-,5,0,7,27,0,0,39,0,0,8,10,0,0,18,378
2018,Brazil,-,11,12,19,89,0,13,144,7,7,11,107,0,7,139,9608
2018,"Bosnia and Herzegovina",-,76,98,147,2476,3406,2715,8918,83,126,148,2403,1902,2844,7506,164312
2018,Bulgaria,-,0,0,6,24,11,27,68,0,12,0,20,36,48,116,987
2018,Belize,-,0,0,5,0,0,0,5,0,5,0,0,0,0,5,287
2018,Cambodia,-,14,17,41,238,5,5660,5975,13,36,22,225,11,5840,6147,12888
2018,Canada,-,0,0,13,6,0,0,19,0,0,5,5,0,0,10,160
2018,"Central African Rep.",-,52152,77918,44479,142799,9737,328321,655406,52963,76823,44129,112540,8804,315621,610880,1270803
2018,"Cayman Islands",-,0,0,0,0,0,0,0,0,0,0,0,0,0,0,6
2018,Chad,-,15941,15409,13681,35742,9210,528,90511,14514,21362,25441,30630,9900,1110,102957,197334
2018,China,-,221,224,142,2924,169,2799,6479,268,225,181,3813,142,3918,8547,306390
2018,Chile,-,0,0,5,58,37,44,144,0,0,0,62,75,37,174,993
2018,Cameroon,-,2849,3713,2268,10995,843,382012,402680,2880,3571,2031,9688,455,287857,306482,732261
2018,Congo,-,142,138,194,649,14,1707,2844,118,181,146,888,45,1845,3223,163208
2018,"Dem. Rep. of the Congo",-,555351,697410,387625,1035727,144823,8055,2828991,557762,512792,398805,864375,113052,8782,2455568,5381452
2018,Comoros,-,0,0,0,11,0,210,221,0,5,5,16,0,373,399,1124
2018,Colombia,-,5224,7204,8803,15327,1828,4012414,4050800,5659,7832,9521,16758,1925,3804806,3846501,8000730
2018,"Costa Rica",-,0,5,5,5,0,5,20,0,0,0,0,0,0,0,755
2018,Cuba,-,72,82,91,2949,53,74,3321,70,82,74,6422,72,132,6852,32085
2018,"Cabo Verde",-,0,0,0,0,0,0,0,0,0,0,0,0,0,0,216
2018,Cyprus,-,0,0,0,0,0,0,0,0,0,0,0,0,0,0,27
2018,Czechia,-,0,0,0,94,203,16,313,0,0,6,131,350,16,503,1460
2018,Denmark,-,0,0,0,0,0,0,0,0,0,0,0,0,0,0,35
2018,Djibouti,-,18,32,16,112,10,198,386,0,26,18,111,0,125,280,3224
2018,Dominica,-,0,0,0,0,0,0,0,0,0,0,0,0,0,0,92
2018,"Dominican Rep.",-,0,0,5,303,0,44,352,0,5,5,185,0,12,207,3878
2018,Ecuador,-,20,17,13,33,0,12,95,23,23,0,38,0,13,97,19151
2018,"Equatorial Guinea",-,0,13,5,16,0,17,51,0,0,0,17,5,15,37,316
2018,Eritrea,-,13497,23329,18883,105218,6093,11945,178965,14402,24684,26169,172960,7265,17538,263018,585930
2018,Estonia,-,0,0,0,0,0,7,7,0,0,5,0,0,0,5,318
2018,Ethiopia,-,6841,9321,6548,38410,1279,1335153,1397552,7137,9957,7055,42188,1628,1282880,1350845,2845514
2018,"French Guiana",-,0,0,0,0,0,0,0,0,0,0,0,0,0,0,23
2018,Fiji,-,0,0,0,0,0,0,0,0,0,0,0,0,0,0,1972
2018,Finland,-,0,0,0,0,0,0,0,0,0,0,0,0,0,0,10
2018,France,-,0,0,0,5,0,0,5,0,5,0,5,5,5,20,278
2018,Gabon,-,6,5,0,23,0,97,131,0,8,0,34,0,82,124,1081
2018,Gambia,-,115,58,43,577,0,197,990,95,65,154,7781,8,124,8227,31253
2018,Palestinian,-,478,1502,1161,6074,1029,349,10593,486,1566,1227,6957,1187,591,12014,115648
2018,"United Kingdom of Great Britain and Northern Ireland",-,0,6,0,6,0,0,12,0,5,5,9,0,0,19,268
2018,Georgia,-,11571,17061,10914,80549,33101,1697,154893,12083,18445,11804,72719,20874,1569,137494,310371
2018,Germany,-,0,0,0,0,0,5,5,0,0,0,0,0,0,0,237
2018,Ghana,-,1357,1436,612,2826,314,199,6744,1306,1603,606,2556,157,327,6555,30613
2018,Guinea-Bissau,-,22,5,12,77,0,309,425,10,16,15,380,0,598,1019,4893
2018,Greece,-,0,0,0,0,6,0,6,0,0,0,11,32,0,43,235
2018,Grenada,-,0,0,0,0,0,0,0,0,0,0,0,0,0,0,155
2018,Guatemala,-,42,62,55,304,5,5,473,39,71,59,499,9,9,686,106027
2018,Guinea,-,342,188,115,1521,19,5515,7700,304,154,695,7098,18,3804,12073,56538
2018,Guyana,-,0,0,5,0,0,5,10,0,0,0,6,0,12,18,834
2018,Haiti,-,33,35,57,734,44,1619,2522,35,50,24,1097,57,1948,3211,68490
2018,"China, Hong Kong SAR",-,0,0,0,0,0,0,0,0,6,0,0,0,0,6,33
2018,Honduras,-,383,626,349,2919,61,90152,94490,452,719,511,4860,67,89059,95668,315803
2018,Croatia,-,0,19,191,5531,7949,42,13732,0,0,263,5377,4376,36,10052,28560
2018,Hungary,-,6,20,29,137,66,20,278,8,11,27,151,147,41,385,4731
2018,Iceland,-,0,0,0,5,0,0,5,0,0,0,0,0,0,0,10
2018,"Cote d'Ivoire",-,1419,2284,1738,6950,390,2608,15389,1465,2341,1752,8994,308,1677,16537,61187
2018,India,-,102,61,87,817,17,70,1154,97,88,81,2810,28,166,3270,61602
2018,Indonesia,-,10,5,0,950,0,6,971,13,10,9,6,8,7,53,15543
2018,Ireland,-,0,0,0,0,0,0,0,0,0,0,0,0,0,0,59
2018,"Iran (Islamic Rep. of)",-,2690,4280,3577,34754,2278,1578,49157,2695,4743,4131,58764,2762,2571,75666,217395
2018,Iraq,-,20395,37465,26335,114076,12258,5055,215584,21179,41595,29456,157593,11335,6270,267428,2439781
2018,Israel,-,0,11,5,37,0,12,65,0,9,10,33,0,0,52,1175
2018,Italy,-,11,6,5,6,0,5,33,9,5,0,10,5,0,29,450
2018,Jamaica,-,0,0,12,74,0,5,91,0,7,5,168,0,11,191,3943
2018,Jordan,-,48,99,53,1797,35,42,2074,50,95,78,430,10,40,703,7980
2018,Japan,-,0,5,5,5,0,0,15,0,0,9,0,0,0,9,156
2018,Kazakhstan,-,26,34,23,1187,38,332,1640,31,42,51,1822,7,257,2210,8353
2018,Kenya,-,444,409,365,1430,178,80,2906,501,438,371,944,137,71,2462,14767
2018,Kyrgyzstan,-,31,90,72,287,18,154,652,35,101,46,447,10,169,808,5655
2018,"Rep. of Korea",-,0,0,0,39,6,0,45,0,0,0,56,7,0,63,810
2018,"Dem. People's Rep. of Korea",-,8,5,5,31,0,0,49,0,0,14,35,0,0,49,943
2018,Kuwait,-,12,36,49,91,0,22,210,14,53,36,89,0,99,291,2471
2018,"Lao People's Dem. Rep.",-,0,0,6,0,8,3177,3191,0,5,0,36,7,3562,3610,7237
2018,Liberia,-,110,174,196,946,42,82,1550,122,186,169,1319,38,173,2007,8582
2018,Libya,-,231,301,222,839,21,90666,92280,233,369,189,1943,45,80733,83512,191153
2018,"Saint Lucia",-,0,0,15,30,0,0,45,0,6,9,24,0,0,39,1090
2018,Lebanon,-,257,252,278,1377,128,47,2339,248,366,265,1770,72,110,2831,13692
2018,Lesotho,-,0,0,0,0,0,0,0,0,0,0,5,0,0,5,44
2018,"Sri Lanka",-,215,236,205,1875,298,9568,12397,215,278,230,6342,288,18766,26119,163945
2018,Lithuania,-,0,0,5,5,0,0,10,0,0,0,0,0,9,9,155
2018,Luxembourg,-,0,0,0,0,0,0,0,0,0,0,0,0,0,0,5
2018,Latvia,-,0,0,0,0,0,16,16,0,0,0,18,0,17,35,255
2018,"China, Macao SAR",-,0,0,0,0,0,0,0,0,0,0,0,0,0,0,25
2018,Madagascar,-,0,0,0,20,0,112,132,5,5,0,5,0,106,121,409
2018,Mauritania,-,1195,3893,2587,6593,650,1320,16238,1277,3950,2566,6330,776,4099,18998,45171
2018,"North Macedonia",-,159,202,222,759,78,181,1601,175,259,200,750,45,186,1615,4949
2018,Monaco,-,0,0,0,0,0,0,0,0,0,0,0,0,0,0,5
2018,"Rep. of Moldova",-,70,73,98,350,27,160,778,74,97,67,306,8,159,711,6934
2018,Maldives,-,0,0,5,0,0,5,10,0,0,0,5,6,0,11,109
2018,Mexico,-,0,5,0,68,0,15,88,0,12,11,49,0,14,86,102664
2018,"Marshall Islands",-,0,0,0,0,0,0,0,0,0,0,0,0,0,0,7
2018,Mali,-,11597,18163,11286,30805,2569,3802,78222,11882,18057,11086,20541,2592,981,65139,289456
2018,Malaysia,-,5,12,5,313,0,5,340,0,12,0,1129,0,6,1147,15854
2018,Malawi,-,16,14,0,105,0,0,135,13,13,0,108,0,0,134,3272
2018,Mongolia,-,128,92,68,573,24,265,1150,101,137,41,497,10,185,971,6643
2018,Morocco,-,111,59,53,812,18,211,1264,120,70,69,1497,16,461,2233,12056
2018,Mozambique,-,142,222,113,3578,44,5,4104,139,213,121,3472,25,6,3976,9034
2018,Malta,-,0,0,0,0,0,0,0,0,0,0,0,0,0,0,15
2018,Montenegro,-,36,37,35,187,31,50,376,34,43,36,158,13,44,328,1348
2018,Mauritius,-,0,10,0,29,0,16,55,0,6,0,23,0,10,39,450
2018,Myanmar,-,110856,132940,89630,338552,31610,5571,709159,114995,139732,91476,331105,27107,5800,710215,1546012
2018,Namibia,-,25,56,53,124,0,0,258,34,61,61,485,39,0,680,1663
2018,Nepal,-,5,9,11,468,10,54,557,13,5,20,438,0,97,573,17992
2018,"Netherlands (Kingdom of the)",-,10,0,0,6,0,0,16,9,0,0,5,0,0,14,132
2018,Niger,-,9373,20319,8477,30210,2725,31,71135,9355,19551,7528,20794,3682,58,60968,186636
2018,Nicaragua,-,31,52,19,308,10,13,433,33,46,44,665,6,21,815,33936
2018,Nigeria,-,24491,34445,15706,59305,4471,1796,140214,24840,33853,15045,49039,4888,833,128498,2530807
2018,Niue,-,0,0,0,0,0,0,0,0,0,0,0,0,0,0,24
2018,Norway,-,0,0,0,0,0,0,0,0,0,0,0,0,0,0,16
2018,"New Zealand",-,0,0,0,0,0,0,0,0,0,0,8,0,0,8,48
2018,Oman,-,0,0,6,0,0,0,6,0,9,0,0,0,0,9,70
2018,Pakistan,-,16267,19541,10888,42561,4127,319,93703,17490,22931,12410,56947,5513,1460,116751,303969
2018,Panama,-,8,0,0,0,0,0,8,0,0,0,0,0,0,0,185
2018,Paraguay,-,5,0,0,8,0,6,19,0,0,0,14,0,0,14,351
2018,Peru,-,0,5,7,273,65,140,490,0,5,5,249,66,183,508,7474
2018,Philippines,-,16,10,5,409,5,39608,40053,14,27,0,358,0,38048,38447,162015
2018,"Papua New Guinea",-,0,0,0,0,0,0,0,0,0,0,0,0,0,0,869
2018,Poland,-,0,0,5,67,118,65,255,5,0,6,139,325,74,549,1997
2018,Portugal,-,0,10,0,0,0,5,15,0,0,0,6,0,0,6,265
2018,Qatar,-,0,0,0,0,0,0,0,0,0,0,0,0,0,0,63
2018,Romania,-,5,0,10,34,39,70,158,6,5,7,51,82,90,241,5408
2018,"South Africa",-,26,41,39,209,6,19,340,33,71,17,258,7,23,409,2886
2018,"Russian Federation",-,1629,1868,2667,7823,730,8848,23565,1889,3121,1891,7999,382,8047,23329,104725
2018,Rwanda,-,25408,33526,23159,46628,2717,1956,133394,22120,34518,24681,47855,3648,1468,134290,276239
2018,"El Salvador",-,161,217,175,1497,41,23,2114,192,259,228,2396,33,32,3140,250619
2018,"Saudi Arabia",-,12,48,12,146,0,7,225,5,38,39,89,0,5,176,2938
2018,"Serbia and Kosovo: S/RES/1244 (1999)",-,3422,9701,10598,65478,27596,6909,123704,3483,9758,11905,67896,22991,7469,123502,257864
2018,Senegal,-,246,452,375,1174,108,897,3252,280,459,369,2283,166,481,4038,35617
2018,Seychelles,-,0,0,0,0,0,0,0,0,0,0,0,0,0,0,15
2018,Singapore,-,0,0,0,0,0,0,0,0,8,0,0,0,0,8,116
2018,"Sierra Leone",-,229,229,250,1201,6,216,2131,140,208,270,2462,13,377,3470,12268
2018,"Solomon Islands",-,0,0,0,6,0,0,6,0,0,0,0,0,0,0,178
2018,Somalia,-,383617,377876,217325,751572,27433,1937,1759760,403445,393030,220783,720839,28740,3335,1770172,3653620
2018,Spain,-,0,10,13,5,0,0,28,0,12,10,12,7,5,46,284
2018,"Viet Nam",-,64,116,98,696,199,3912,5085,94,122,95,1155,237,4908,6611,340103
2018,"Saint Kitts and Nevis",-,0,0,0,0,0,0,0,0,0,0,5,0,0,5,69
2018,"Sao Tome and Principe",-,0,5,0,10,0,5,20,0,5,0,6,0,0,11,56
2018,Sudan,-,61046,87862,58158,163735,13051,1287,385139,63232,89095,57539,134352,11416,13573,369207,2656415
2018,Suriname,-,0,7,0,0,0,5,12,0,0,0,0,0,0,0,79
2018,"South Sudan",-,200058,306137,181666,456946,44778,1020347,2209932,203334,312939,200665,327691,26935,903647,1975211,4186156
2018,Slovakia,-,0,13,10,46,17,57,143,0,13,9,65,37,56,180,1608
2018,Slovenia,-,0,0,0,0,0,0,0,0,0,0,0,6,0,6,29
2018,Eswatini,-,0,0,0,25,0,0,25,0,0,5,22,0,0,27,285
2018,Sweden,-,8,0,0,0,0,0,8,0,0,0,0,0,0,0,45
2018,Switzerland,-,0,0,0,0,0,0,0,0,0,0,0,0,0,0,18
2018,"Syrian Arab Rep.",-,467034,575002,351577,1424851,101950,10955,2931369,497761,613917,399823,1780415,90713,13455,3396084,12986323
2018,"United Rep. of Tanzania",-,43,33,28,115,0,0,219,37,41,11,275,0,17,381,2392
2018,"Turks and Caicos Islands",-,0,0,0,0,0,0,0,0,0,0,0,0,0,0,14
2018,Thailand,-,0,5,0,414,0,0,419,0,0,0,103,7,6,116,2975
2018,Tajikistan,-,235,202,171,652,36,32,1328,269,254,157,1076,8,39,1803,4887
2018,Turkmenistan,-,29,16,34,612,10,17,718,24,38,16,241,0,11,330,1721
2018,Timor-Leste,-,0,0,0,0,0,0,0,0,0,0,0,0,0,0,22
2018,Togo,-,152,348,311,1450,109,507,2877,148,354,280,2914,143,800,4639,11575
2018,Tonga,-,0,0,0,0,0,0,0,0,0,0,0,0,0,0,202
2018,"Trinidad and Tobago",-,0,0,0,7,0,0,7,5,0,0,16,0,0,21,643
2018,Tunisia,-,31,46,29,238,8,184,536,38,34,45,614,7,367,1105,4734
2018,Türkiye,-,1742,2693,2835,17216,2673,4378,31537,1879,3052,2798,27887,2433,10151,48200,111825
2018,"United Arab Emirates",-,5,5,0,7,0,0,17,0,16,6,24,7,0,53,441
2018,Uganda,-,181,259,186,1273,21,66,1986,195,229,185,1490,44,102,2245,197990
2018,Ukraine,-,282,287,310,1822,302,976,3979,248,413,215,1548,138,785,3347,1625215
2018,Uruguay,-,0,5,0,0,0,0,5,0,0,0,5,0,0,5,210
2018,"United States of America",-,25,33,29,44,11,0,142,16,30,30,64,10,0,150,3166
2018,Uzbekistan,-,26,104,63,523,29,143,888,52,94,94,439,12,118,809,7882
2018,Vanuatu,-,0,0,0,0,0,0,0,0,0,0,0,0,0,0,52
2018,"Saint Vincent and the Grenadines",-,0,6,11,44,0,0,61,0,5,7,23,0,0,35,1314
2018,"Venezuela (Bolivarian Republic of)",-,4131,5001,2901,85248,1313,609384,707978,4489,5197,3225,132231,902,562480,708524,3078217
2018,Samoa,-,0,0,0,0,0,0,0,0,0,0,0,0,0,0,42
2018,"Western Sahara",-,0,0,0,31,0,98,129,0,0,0,119,0,484,603,118593
2018,Yemen,-,151986,217810,216879,483596,43780,245,1114296,130604,239468,217259,456669,44032,369,1088401,2211740
2018,Zambia,-,0,0,12,15,0,5,32,0,0,0,0,0,0,0,520
2018,Zimbabwe,-,119,174,119,978,21,26,1437,123,181,111,845,16,27,1303,32849
2018,Stateless,-,450,703,566,2632,178,168,4697,441,850,684,5412,253,363,8003,62871
2018,Tibetan,-,0,0,0,7003,0,0,7003,0,0,0,6506,0,0,6506,13527
2018,Guadeloupe,-,0,0,0,0,0,0,0,0,0,0,0,0,0,0,11
2018,"Curacao ",-,0,0,0,0,0,0,0,0,0,0,0,0,0,0,35
2018,"Unknown ",-,2458,2244,1786,8574,606,1578,17246,2664,2784,2276,18211,688,3234,29857,429348
2019,Afghanistan,-,379088,486135,372010,937456,94087,17939,2286715,378944,521686,409623,1079519,116967,54435,2561174,5982668
2019,Albania,-,231,326,225,1348,70,6908,9108,286,330,315,1564,55,8443,10993,34034
2019,Algeria,-,86,78,29,430,16,1347,1986,102,101,54,1527,39,3497,5320,12324
2019,Angola,-,1400,2372,1607,5013,533,1924,12849,1353,2297,1634,4122,926,2349,12681,37191
2019,"Antigua and Barbuda",-,0,0,0,0,0,0,0,0,0,0,0,0,9,9,182
2019,Egypt,-,308,477,294,1235,57,803,3174,277,554,324,2834,77,3627,7693,44392
2019,Argentina,-,0,0,5,22,0,150,177,10,8,0,21,7,178,224,1036
2019,Armenia,-,383,401,269,2367,512,2691,6623,364,489,387,2526,358,2704,6828,22064
2019,Australia,-,0,5,0,0,0,0,5,0,0,5,0,0,0,5,70
2019,Austria,-,0,5,0,0,0,0,5,0,0,0,0,0,0,0,28
2019,Azerbaijan,-,470,648,332,3022,628,1883,6983,487,776,466,3157,398,2021,7305,672184
2019,Bahrain,-,5,11,18,19,0,6,59,12,9,5,84,0,21,131,713
2019,Barbados,-,0,0,0,0,0,0,0,0,0,0,0,0,5,5,359
2019,Burundi,-,42610,44113,29696,108804,5348,575,231146,42573,45661,30009,112511,4855,702,236311,484927
2019,Belgium,-,0,0,0,6,0,0,6,0,0,0,0,0,0,0,139
2019,Benin,-,33,5,0,81,0,60,179,20,5,6,225,0,82,338,1941
2019,Bangladesh,-,51,45,28,245,5,1605,1979,55,41,46,2147,19,10668,12976,86128
2019,Bahamas,-,0,0,0,0,0,0,0,0,0,0,0,0,0,0,1029
2019,Bhutan,-,224,400,357,1679,320,22,3002,235,428,389,1946,453,104,3555,7252
2019,"Burkina Faso",-,51793,76214,41132,112965,8553,188,290845,51988,78414,45855,92926,9148,340,278671,578952
2019,Belarus,-,24,45,19,199,12,371,670,22,43,30,202,22,477,796,7437
2019,"Bolivia (Plurinational State of)",-,5,13,5,54,0,92,169,10,0,0,57,0,114,181,1752
2019,Botswana,-,0,0,5,23,0,52,80,0,5,7,15,0,11,38,367
2019,Brazil,-,258,20,19,96,5,544,942,274,29,6,130,0,628,1067,13433
2019,"Brunei Darussalam",-,0,0,0,0,0,0,0,0,0,0,0,0,0,0,10
2019,"Bosnia and Herzegovina",-,55,83,82,830,222,73250,74522,70,101,77,707,151,76313,77419,163371
2019,Bulgaria,-,0,7,0,15,11,27,60,0,10,5,10,33,48,106,915
2019,Belize,-,0,0,0,7,0,0,7,6,0,5,11,0,0,22,351
2019,Cambodia,-,12,8,45,211,12,5434,5722,8,27,24,205,19,5587,5870,12832
2019,Canada,-,5,7,0,7,0,0,19,0,5,5,5,0,12,27,159
2019,"Central African Rep.",-,105137,166465,87193,293420,21153,1707,675075,108491,146654,88316,255502,20272,1791,621026,1297563
2019,"Cayman Islands",-,0,0,0,0,0,0,0,0,0,0,0,0,0,0,6
2019,Chad,-,25166,35654,25101,74804,6583,653,167961,25828,35649,23664,45935,4446,1353,136875,309143
2019,China,-,189,156,93,1882,134,4689,7143,207,181,120,2379,134,5873,8894,317111
2019,Chile,-,191,0,5,71,38,125,430,184,5,0,63,73,135,460,1737
2019,Cameroon,-,4501,6031,3610,15813,1080,494497,525532,4666,5805,3479,14215,665,460103,488933,1038379
2019,Congo,-,121,166,131,530,19,1926,2893,74,173,166,853,56,2089,3411,158437
2019,"Dem. Rep. of the Congo",-,584907,778607,449386,1145240,73018,10726,3041884,548766,785945,464464,961847,64497,11654,2837173,5975857
2019,Comoros,-,0,5,9,123,0,229,366,0,7,5,221,0,409,642,2117
2019,Colombia,-,5084,6813,8500,12746,1741,4323970,4358854,5159,6905,8631,13183,1756,4087720,4123354,8641214
2019,"Costa Rica",-,6,5,10,6,0,35,62,0,0,9,17,0,41,67,945
2019,Cuba,-,193,205,150,6491,88,846,7973,160,272,165,12701,112,1315,14725,62569
2019,"Cabo Verde",-,0,5,0,0,0,0,5,0,0,0,10,0,0,10,260
2019,Cyprus,-,0,0,0,0,0,0,0,0,0,0,0,0,6,6,35
2019,Czechia,-,0,0,0,74,203,10,287,0,0,0,110,339,14,463,1347
2019,Denmark,-,0,0,0,0,0,0,0,0,0,0,0,0,0,0,42
2019,Djibouti,-,5,13,5,42,5,232,302,0,15,8,58,0,160,241,3185
2019,Dominica,-,0,0,0,0,0,29,29,0,0,0,0,0,15,15,132
2019,"Dominican Rep.",-,5,0,7,420,0,217,649,5,5,5,328,0,114,457,4584
2019,Ecuador,-,5,14,12,36,0,134,201,10,5,14,46,5,159,239,20984
2019,"Equatorial Guinea",-,0,5,5,12,0,46,68,0,0,0,12,6,64,82,322
2019,Eritrea,-,17972,25097,22848,111956,6595,2860,187328,18630,28140,28667,133306,7581,6723,223047,576598
2019,Estonia,-,0,0,0,0,0,0,0,0,0,5,0,0,5,10,329
2019,Ethiopia,-,6860,9675,6476,39837,1474,1368,65690,7332,10196,7168,41196,1830,1901,69623,1966243
2019,"French Guiana",-,0,0,0,0,0,0,0,0,0,0,0,0,0,0,24
2019,Fiji,-,0,0,0,0,0,0,0,0,0,0,0,0,5,5,2934
2019,Finland,-,0,0,0,0,0,0,0,0,0,0,0,0,5,5,10
2019,France,-,0,0,0,0,0,0,0,0,5,5,10,5,5,30,318
2019,Gabon,-,7,0,0,27,0,152,186,7,0,0,28,0,128,163,1333
2019,Gambia,-,138,66,43,587,0,414,1248,103,66,111,5323,7,1052,6662,26974
2019,Palestinian,-,486,1185,866,4844,901,36478,44760,428,1219,968,5539,1009,38706,47869,108894
2019,"United Kingdom of Great Britain and Northern Ireland",-,5,0,0,5,0,0,10,7,6,0,7,0,5,25,296
2019,Georgia,-,10955,18000,10972,80535,34458,4240,159160,11457,19091,12052,73462,21720,4459,142241,313469
2019,Germany,-,0,0,0,0,0,5,5,0,0,0,0,0,10,10,270
2019,Ghana,-,1375,1453,567,2760,310,529,6994,1316,1577,608,2110,164,1317,7092,28983
2019,Guinea-Bissau,-,20,13,0,67,0,335,435,10,10,13,280,0,745,1058,4758
2019,Greece,-,0,0,0,0,7,0,7,0,0,0,11,33,0,44,228
2019,Grenada,-,0,0,0,0,0,14,14,0,0,0,0,0,15,15,169
2019,Guatemala,-,173,233,174,1023,16,286,1905,163,261,175,1471,31,408,2509,190127
2019,Guinea,-,465,245,168,1865,17,6631,9391,433,224,654,6648,12,6742,14713,57266
2019,Guyana,-,0,0,0,0,0,5,5,5,0,0,5,0,28,38,960
2019,Haiti,-,125,224,113,2380,28,1744,4614,113,188,93,3394,47,2142,5977,92418
2019,"China, Hong Kong SAR",-,0,0,0,0,0,0,0,0,0,0,0,0,16,16,227
2019,Honduras,-,1429,2012,1117,7874,96,143657,156185,1510,2245,1532,11901,136,118584,135908,468758
2019,Croatia,-,5,19,179,3365,1251,30,4849,5,9,156,3308,884,31,4393,27612
2019,Hungary,-,0,5,0,12,65,20,102,0,0,0,30,139,34,203,4683
2019,Iceland,-,0,0,0,5,0,0,5,0,0,0,0,0,0,0,10
2019,"Cote d'Ivoire",-,1360,2104,1754,7149,401,3967,16735,1343,2117,1629,9043,318,3002,17452,59264
2019,India,-,70,52,43,614,25,953,1757,93,54,55,1041,40,2646,3929,78046
2019,Indonesia,-,12,5,0,1003,5,64,1089,0,13,5,12,5,51,86,16362
2019,Ireland,-,0,0,0,0,0,0,0,0,0,0,0,0,0,0,90
2019,"Iran (Islamic Rep. of)",-,2372,3835,3198,32230,2344,6018,49997,2364,4201,3656,51612,2915,12403,77151,215496
2019,Iraq,-,18775,42091,27953,119894,12625,12632,233970,20455,45092,31765,149989,11180,21631,280112,2085397
2019,Israel,-,0,9,5,23,0,21,58,0,0,13,30,5,26,74,1142
2019,Italy,-,5,15,0,6,0,0,26,5,7,0,11,0,5,28,507
2019,Jamaica,-,0,0,0,20,0,71,91,5,0,0,129,0,158,292,4327
2019,Jordan,-,83,98,66,2143,47,232,2669,69,101,65,446,11,403,1095,8984
2019,Japan,-,0,0,9,10,0,0,19,0,0,9,0,0,9,18,150
2019,Kazakhstan,-,10,21,12,123,27,536,729,10,33,18,130,6,485,682,9739
2019,Kenya,-,453,467,333,1462,176,352,3243,535,463,377,952,123,195,2645,15589
2019,Kyrgyzstan,-,49,65,24,162,11,221,532,38,60,32,154,10,315,609,5556
2019,"Rep. of Korea",-,0,0,0,17,5,5,27,0,0,5,25,0,5,35,823
2019,"Dem. People's Rep. of Korea",-,5,0,5,48,6,14,78,0,0,5,61,7,10,83,870
2019,Kuwait,-,0,40,51,95,0,240,426,6,37,73,89,0,394,599,2712
2019,"Lao People's Dem. Rep.",-,0,0,0,0,7,3045,3052,0,0,5,32,8,3419,3464,7147
2019,Liberia,-,120,198,217,982,53,96,1666,138,197,225,1182,51,263,2056,8351
2019,Libya,-,180,311,178,819,29,771,2288,211,376,191,1851,45,1698,4372,377733
2019,"Saint Lucia",-,0,0,0,0,0,16,16,0,0,0,0,0,11,11,917
2019,Lebanon,-,290,465,311,4803,429,507,6805,284,587,376,1643,95,740,3725,18709
2019,Lesotho,-,0,0,0,5,0,0,5,0,0,0,0,0,5,5,55
2019,Liechtenstein,-,0,0,0,0,0,0,0,0,0,0,0,0,0,0,14
2019,"Sri Lanka",-,223,361,188,2135,434,38346,41687,237,299,284,6089,378,46657,53944,151523
2019,Lithuania,-,0,0,0,5,0,0,5,0,0,0,0,0,13,13,137
2019,Luxembourg,-,0,0,0,5,0,0,5,0,0,0,0,0,0,0,5
2019,Latvia,-,0,5,0,0,0,15,20,0,0,0,13,0,17,30,242
2019,"China, Macao SAR",-,0,0,0,0,0,0,0,0,0,0,0,0,5,5,33
2019,Madagascar,-,5,0,0,17,0,119,141,0,8,0,0,0,105,113,562
2019,Mauritania,-,951,3865,2711,6654,721,1394,16296,1050,3946,2687,6383,819,4439,19324,46003
2019,"North Macedonia",-,132,176,160,627,67,283,1445,119,214,136,639,49,303,1460,4310
2019,Monaco,-,0,0,0,0,0,0,0,0,0,0,0,0,0,0,5
2019,"Rep. of Moldova",-,121,123,82,431,42,347,1146,107,129,78,470,22,326,1132,8080
2019,Maldives,-,0,0,5,0,0,5,10,0,0,0,0,0,5,5,86
2019,Mexico,-,0,0,0,25,0,121,146,0,5,7,21,0,159,192,116275
2019,"Marshall Islands",-,0,0,0,0,0,0,0,0,0,0,0,0,0,0,7
2019,Mali,-,11415,19036,12292,32117,2584,115400,192844,11492,18851,12046,21142,2616,99449,165596,380804
2019,Malaysia,-,0,6,0,29,0,141,176,0,8,0,20,0,211,239,22165
2019,Malawi,-,14,19,10,106,0,55,204,12,11,5,110,0,30,168,3084
2019,Mongolia,-,68,59,24,255,23,548,977,59,85,43,179,12,460,838,6431
2019,Morocco,-,116,78,34,693,19,1050,1990,108,94,83,1359,13,3122,4779,13224
2019,Mozambique,-,154,233,135,325,46,5,898,154,234,122,217,28,23,778,189327
2019,Malta,-,0,0,0,0,0,0,0,0,0,0,0,0,0,0,20
2019,Montenegro,-,23,36,29,171,33,62,354,25,35,35,141,12,59,307,1265
2019,Mauritius,-,5,10,0,15,0,63,93,0,0,5,20,0,68,93,482
2019,Myanmar,-,116488,124735,87920,324036,24185,24377,701741,119595,129776,92706,330155,26484,19704,718420,1426420
2019,Namibia,-,0,0,0,14,0,374,388,0,0,0,21,0,285,306,1215
2019,Nepal,-,10,0,10,384,9,261,674,11,5,0,138,0,469,623,18319
2019,"Netherlands (Kingdom of the)",-,9,0,0,7,0,0,16,15,0,0,5,0,0,20,157
2019,Niger,-,10812,22719,9423,29084,3509,50,75597,9651,20263,8419,26507,3138,160,68138,227267
2019,Nicaragua,-,79,97,46,666,15,3073,3976,73,96,91,1352,16,3490,5118,71469
2019,Nigeria,-,29130,43969,19169,68018,5196,5054,170536,27718,41212,17343,54701,5151,4160,150285,2603746
2019,Niue,-,0,0,0,0,0,0,0,0,0,0,0,0,0,0,25
2019,Norway,-,0,0,0,0,0,0,0,0,0,0,0,0,0,0,16
2019,Nauru,-,0,0,0,0,0,0,0,0,0,0,0,0,0,0,15
2019,"New Zealand",-,0,0,0,0,0,0,0,0,0,0,8,0,0,8,61
2019,Oman,-,0,5,0,0,0,6,11,0,15,0,0,0,16,31,101
2019,Pakistan,-,16542,19894,10873,42729,4139,2227,96404,17866,23315,12555,50693,5530,14900,124859,306698
2019,Panama,-,5,0,0,0,0,30,35,6,0,0,0,0,40,46,285
2019,Paraguay,-,5,0,0,9,0,176,190,0,0,0,21,0,185,206,716
2019,Peru,-,10,0,0,255,71,2062,2398,11,0,5,242,74,1966,2298,11434
2019,Philippines,-,18,11,10,101,5,91415,91560,10,27,0,5,0,87720,87762,239212
2019,"Papua New Guinea",-,0,0,0,0,0,0,0,0,0,0,0,0,0,0,1024
2019,Poland,-,0,0,5,42,128,62,237,0,0,5,109,330,70,514,1977
2019,Portugal,-,0,0,5,0,0,0,5,0,0,5,5,0,5,15,363
2019,Qatar,-,0,0,5,0,0,5,10,0,0,0,0,0,5,5,72
2019,Romania,-,0,5,12,32,39,61,149,6,5,6,43,79,93,232,5262
2019,"South Africa",-,54,50,40,265,11,112,532,35,79,24,179,14,110,441,3286
2019,"Russian Federation",-,1339,2654,1629,6701,752,11070,24145,1462,2887,1840,6294,401,10511,23395,110635
2019,Rwanda,-,25361,33306,23142,48017,2781,1647,134254,22187,34297,24627,48383,3769,1538,134801,277699
2019,"El Salvador",-,376,499,353,3073,73,3677,8051,390,574,472,4673,61,3736,9906,282785
2019,"Saudi Arabia",-,17,53,5,102,0,124,301,11,50,40,61,0,80,242,3157
2019,"Serbia and Kosovo: S/RES/1244 (1999)",-,1256,1628,1667,8163,2327,7115,22156,1357,1678,1689,9080,2215,7741,23760,253410
2019,Senegal,-,197,691,576,1686,245,1178,4573,215,679,585,2855,235,1670,6239,32539
2019,Seychelles,-,0,0,0,0,0,6,6,0,0,0,0,0,0,0,21
2019,Singapore,-,0,0,0,0,0,0,0,0,8,0,0,0,5,13,127
2019,"Sierra Leone",-,320,349,246,1197,32,447,2591,290,290,337,2256,32,846,4051,12560
2019,"Solomon Islands",-,0,0,0,6,0,0,6,0,0,0,0,0,0,0,261
2019,Somalia,-,389940,363140,209037,739112,27050,3993,1732272,409939,378283,213198,716324,28344,6520,1752608,3602839
2019,Spain,-,0,17,5,5,0,0,27,0,7,16,5,6,0,34,327
2019,"Viet Nam",-,72,106,90,666,222,4391,5547,84,118,87,1053,264,6049,7655,324604
2019,"Saint Kitts and Nevis",-,0,0,0,0,0,6,6,0,0,0,0,0,6,6,74
2019,"Sao Tome and Principe",-,0,5,0,11,0,10,26,0,0,0,7,0,0,7,57
2019,Sudan,-,62198,87155,58994,167436,12476,1071543,1459802,64131,88878,59540,136794,10839,834907,1195089,2692586
2019,Suriname,-,0,0,0,0,0,5,5,0,0,0,0,0,5,5,89
2019,"South Sudan",-,187219,287166,186728,462275,44504,25,1167917,189728,294621,204209,352953,29988,127,1071626,3916236
2019,Slovakia,-,0,0,0,10,17,55,82,0,0,0,18,33,57,108,1574
2019,Slovenia,-,0,0,0,0,0,0,0,0,0,0,0,6,0,6,34
2019,Eswatini,-,0,0,5,21,0,0,26,0,6,5,14,0,0,25,321
2019,Sweden,-,8,0,0,0,0,0,8,0,0,0,0,0,0,0,48
2019,Switzerland,-,0,0,0,0,0,0,0,0,0,0,0,0,0,0,25
2019,"Syrian Arab Rep.",-,468477,595529,344087,1416959,99811,20310,2945173,498871,632132,385735,1759640,89024,27631,3393033,12888305
2019,"United Rep. of Tanzania",-,60,37,18,173,5,99,392,66,58,14,282,0,116,536,2703
2019,"Turks and Caicos Islands",-,0,0,0,0,0,0,0,0,0,0,0,0,0,0,14
2019,Thailand,-,0,10,0,41,0,61,112,0,7,0,19,7,20,53,3704
2019,Tajikistan,-,195,206,90,536,30,103,1160,212,220,112,808,13,199,1564,4648
2019,Turkmenistan,-,14,29,19,77,13,24,176,19,40,11,87,0,50,207,1054
2019,Timor-Leste,-,0,0,0,0,0,0,0,0,0,0,0,0,8,8,58
2019,Togo,-,144,336,310,1454,117,262,2623,161,319,275,2868,164,759,4546,11414
2019,Tonga,-,0,0,0,0,0,0,0,0,0,0,0,0,0,0,451
2019,"Trinidad and Tobago",-,0,0,0,5,0,41,46,0,0,0,15,0,68,83,915
2019,Tunisia,-,34,40,31,221,10,213,549,38,34,25,487,14,809,1407,4750
2019,Türkiye,-,1892,3241,2764,18481,2685,7175,36238,2042,3398,2969,30304,2542,14626,55881,130237
2019,"United Arab Emirates",-,6,6,5,10,0,0,27,0,7,0,10,0,8,25,336
2019,Uganda,-,205,246,164,988,32,466,2101,173,231,179,1435,68,440,2526,2323247
2019,Ukraine,-,199,341,182,1366,298,1356411,1358797,201,385,198,1117,144,1067184,1069229,2502092
2019,Uruguay,-,0,5,0,0,0,60,65,5,0,0,5,0,60,70,326
2019,"United States of America",-,21,26,36,43,10,98,234,5,21,28,61,16,123,254,3249
2019,Uzbekistan,-,11,31,23,138,19,456,678,28,49,23,135,8,1316,1559,8219
2019,Vanuatu,-,0,0,0,0,0,0,0,0,0,0,0,0,0,0,75
2019,"Holy See",-,0,0,0,0,0,0,0,0,0,0,0,0,0,0,5
2019,"Saint Vincent and the Grenadines",-,0,0,0,0,0,5,5,0,0,0,5,0,11,16,1056
2019,"Venezuela (Bolivarian Republic of)",-,1719,47902,59888,191426,15637,872105,1188677,1980,35429,43614,142746,11701,940969,1176439,4964435
2019,Samoa,-,0,0,0,0,0,0,0,0,0,0,0,0,0,0,84
2019,"Western Sahara",-,0,0,0,24,0,134,158,0,0,0,99,0,647,746,117868
2019,Yemen,-,255522,365915,365104,809444,73470,637,1870092,219361,402378,365427,753315,73732,1874,1816087,3696615
2019,Zambia,-,0,5,5,25,0,26,61,0,0,0,5,0,20,25,723
2019,Zimbabwe,-,115,189,112,1093,20,257,1786,127,195,118,869,5,228,1542,296343
2019,Stateless,-,141353,112719,70365,411980,37665,247815,1021897,147699,132219,65918,330985,42951,249847,969619,3114723
2019,Tibetan,-,0,0,0,6520,0,0,6520,0,0,0,6020,0,0,6020,12555
2019,"Curacao ",-,0,0,0,0,0,0,0,0,0,0,0,0,0,0,35
2019,"Unknown ",-,2798,2592,1880,9500,672,76050,93492,2988,2918,2413,18818,808,79785,107730,574736
2020,Afghanistan,-,362894,478849,370034,966784,91943,18599,2289103,367278,492628,401637,1114241,121167,44272,2541223,5807434
2020,Albania,-,165,250,194,1118,47,4661,6435,203,278,211,1242,51,8887,10872,33151
2020,Algeria,-,110,143,60,676,23,1354,2366,149,131,120,2280,51,3028,5759,12446
2020,Andorra,-,0,0,0,0,0,0,0,0,0,0,0,0,0,0,5
2020,Angola,-,1484,2542,1763,5540,559,1086,12974,1499,2460,1770,4640,982,2038,13389,39639
2020,"Antigua and Barbuda",-,0,0,0,0,0,5,5,0,0,0,0,0,11,11,159
2020,Egypt,-,297,539,397,1394,60,1123,3810,255,561,405,2976,76,3792,8065,42954
2020,Argentina,-,7,0,6,41,0,234,288,8,6,6,47,13,287,367,1293
2020,Armenia,-,235,306,202,1758,403,897,3801,238,354,295,1947,303,1403,4540,19184
2020,Australia,-,0,5,0,0,0,0,5,0,0,5,0,0,0,5,32
2020,Austria,-,0,5,0,0,0,0,5,0,0,0,0,0,0,0,18
2020,Azerbaijan,-,5710,5818,5507,36924,10606,737,65302,5982,6319,6056,10351,5410,1078,35196,761814
2020,Bahrain,-,0,14,14,14,0,0,42,11,9,10,91,0,13,134,652
2020,Barbados,-,0,0,0,38,0,28,66,0,0,0,0,0,49,49,350
2020,Burundi,-,38187,42907,28105,90388,5228,1424,206239,38314,43962,28908,109697,4944,1689,227514,462489
2020,Belgium,-,0,5,0,6,0,0,11,0,0,0,0,0,0,0,90
2020,Benin,-,46,15,0,102,0,177,340,17,11,19,240,0,344,631,1968
2020,Bangladesh,-,48,117,58,806,37,4556,5622,57,119,101,28070,60,13991,42398,556855
2020,Bahamas,-,26,40,24,188,0,39,317,29,48,36,156,0,26,295,1229
2020,Bhutan,-,175,393,350,1717,322,5,2962,180,411,424,1965,459,0,3439,7152
2020,"Burkina Faso",-,1227,1611,690,3686,266,571160,578640,1173,1535,673,2354,306,504733,510774,1099600
2020,Belarus,-,12,50,22,176,16,395,671,15,34,34,214,21,668,986,7837
2020,"Bolivia (Plurinational State of)",-,0,27,0,102,0,85,214,7,5,0,84,20,121,237,1905
2020,Botswana,-,0,0,5,28,0,27,60,0,0,10,12,0,58,80,325
2020,Brazil,-,472,46,26,174,5,732,1455,518,72,17,221,0,937,1765,18405
2020,"Brunei Darussalam",-,0,0,0,5,0,0,5,0,0,0,0,0,0,0,10
2020,"Bosnia and Herzegovina",-,37,85,72,718,259,47987,49158,49,63,64,618,164,50182,51140,114369
2020,Bulgaria,-,0,5,5,14,10,30,64,0,10,0,19,32,39,100,865
2020,Belize,-,0,5,0,5,0,0,10,6,6,0,8,0,5,25,382
2020,Cambodia,-,17,17,37,236,12,10,329,15,25,26,225,26,17,334,12778
2020,Canada,-,0,0,7,9,0,10,26,5,0,0,7,0,16,28,173
2020,"Central African Rep.",-,115723,168323,88644,276269,22328,222,671509,115386,168521,87902,268527,22418,449,663203,1339218
2020,"Cayman Islands",-,0,0,0,0,0,0,0,0,0,0,0,0,0,0,5
2020,Chad,-,35012,59481,26445,113845,14613,619,250015,32651,44281,23186,84208,12604,1281,198211,452578
2020,China,-,182,158,100,2687,126,2185,5438,195,205,147,3560,181,3353,7641,283438
2020,Chile,-,467,6,5,135,42,173,828,436,5,0,128,69,241,879,2770
2020,Cameroon,-,4701,7671,4663,252587,20577,291218,581417,4872,7524,4484,215300,18239,283848,534267,1134441
2020,Congo,-,108,318,617,5119,98,597,6857,58,353,595,7452,123,1171,9752,159894
2020,"Dem. Rep. of the Congo",-,74962,100751,68243,212965,13753,5170,475844,75107,101033,68759,212901,11206,7740,476746,6197972
2020,Comoros,-,5,12,5,157,0,660,839,0,6,5,361,0,1467,1839,3436
2020,Colombia,-,582874,631782,647252,2412064,287393,52672,4614037,530388,588429,589679,2282804,267242,47142,4305684,9755473
2020,"Costa Rica",-,11,5,10,10,0,29,65,7,5,5,19,0,46,82,1008
2020,Cuba,-,165,233,181,6676,129,1510,8894,127,296,191,12486,190,1961,15251,71276
2020,"Cabo Verde",-,0,5,0,0,0,0,5,0,0,0,5,0,0,5,263
2020,Cyprus,-,0,0,0,0,0,0,0,0,0,0,0,0,7,7,19
2020,Czechia,-,0,0,0,57,212,44,313,0,0,0,98,339,44,481,1270
2020,Denmark,-,0,0,0,0,0,0,0,0,0,0,0,0,0,0,22
2020,Djibouti,-,0,20,11,49,5,340,425,0,20,13,104,0,367,504,4603
2020,Dominica,-,0,0,0,5,0,7,12,0,0,0,5,0,14,19,129
2020,"Dominican Rep.",-,0,5,19,500,0,158,682,0,10,16,401,0,212,639,4794
2020,Ecuador,-,17,15,24,69,0,219,344,33,5,11,105,6,279,439,23779
2020,"Equatorial Guinea",-,0,5,0,18,0,41,64,0,0,0,6,6,58,70,338
2020,Eritrea,-,16406,29316,25631,122974,6819,4412,205558,17255,30451,32326,142597,7830,7690,238149,607383
2020,Estonia,-,0,0,0,0,0,0,0,0,0,5,12,0,0,17,320
2020,Ethiopia,-,6985,11916,9556,60560,3244,1161,93422,7739,13084,10685,119659,5247,2050,158464,3014051
2020,"French Guiana",-,0,0,0,0,0,0,0,0,0,0,0,0,0,0,27
2020,Fiji,-,0,0,0,0,0,0,0,0,0,0,0,0,0,0,3199
2020,France,-,5,0,0,0,0,24,29,5,5,0,5,6,9,30,224
2020,Gabon,-,8,0,6,31,0,268,313,6,0,0,27,0,515,548,1569
2020,Gambia,-,150,82,34,632,0,604,1502,136,70,96,3143,11,1416,4872,17670
2020,Palestinian,-,492,1306,934,5285,957,37163,46137,472,1379,1025,7002,1053,40458,51389,113578
2020,"United Kingdom of Great Britain and Northern Ireland",-,0,0,0,5,0,5,10,6,11,0,5,0,5,27,262
2020,Georgia,-,10555,18226,11416,80017,35335,3167,158716,10912,19287,12509,73516,22159,4707,143090,311292
2020,Germany,-,0,0,0,0,0,0,0,0,0,0,0,0,5,5,237
2020,Ghana,-,732,1134,954,3427,420,520,7187,127,1069,1325,3183,218,1092,7014,23941
2020,Guinea-Bissau,-,17,13,0,65,0,134,229,18,5,13,261,5,281,583,4351
2020,Greece,-,0,0,0,0,6,0,6,0,0,0,9,32,0,41,212
2020,Grenada,-,0,0,0,0,0,12,12,0,0,0,0,0,26,26,151
2020,Guatemala,-,199,285,215,1414,20,381,2514,203,306,216,2457,41,447,3670,197919
2020,Guinea,-,599,306,182,2356,19,6156,9618,580,260,638,6806,13,8918,17215,58358
2020,Guyana,-,0,0,0,0,0,30,30,5,0,0,0,0,36,41,975
2020,Haiti,-,118,479,266,5564,121,810,7358,179,439,237,7229,77,1561,9722,106004
2020,"China, Hong Kong SAR",-,0,0,0,0,0,23,23,0,0,0,0,0,48,48,502
2020,Honduras,-,16243,25917,20410,77731,8472,5464,154237,13857,22203,17682,73847,7136,6311,141036,546048
2020,Croatia,-,0,7,26,890,250,3420,4593,0,7,21,1067,412,2623,4130,26810
2020,Hungary,-,26,14,45,227,64,114,490,60,55,20,302,136,145,718,5219
2020,Iceland,-,0,0,0,0,0,0,0,0,5,0,0,0,0,5,5
2020,"Cote d'Ivoire",-,2835,4036,2975,12631,940,2566,25983,2708,3997,2959,12839,564,5231,28298,77166
2020,India,-,290,399,217,4006,27,1775,6714,350,525,379,9603,172,4086,15115,82626
2020,Indonesia,-,23,35,0,1068,5,88,1219,24,32,5,43,6,103,213,18139
2020,Ireland,-,0,0,0,0,0,0,0,0,0,0,0,0,0,0,94
2020,"Iran (Islamic Rep. of)",-,2291,3873,3281,32094,2327,6629,50495,2268,4163,3739,50080,3128,12988,76366,212779
2020,Iraq,-,18950,39910,27555,113709,12391,9580,222095,20231,42653,30979,140780,11252,19573,265468,1861133
2020,Israel,-,0,0,12,24,0,40,76,0,7,5,25,5,62,104,1036
2020,Italy,-,0,11,0,5,0,41,57,6,7,0,12,0,40,65,533
2020,Jamaica,-,7,0,0,124,0,142,273,9,0,5,263,0,185,462,4428
2020,Jordan,-,45,158,64,1362,23,353,2005,40,135,127,704,12,576,1594,8306
2020,Japan,-,0,0,9,5,0,0,14,0,0,14,0,0,11,25,161
2020,Kazakhstan,-,8,35,12,130,31,260,476,17,29,20,167,7,453,693,8719
2020,Kenya,-,314,522,383,2196,182,265,3862,348,564,412,1819,152,419,3714,60381
2020,Kyrgyzstan,-,26,62,28,144,9,180,449,29,45,27,150,5,220,476,5578
2020,"Rep. of Korea",-,0,0,0,9,5,0,14,0,6,0,22,0,16,44,869
2020,"Dem. People's Rep. of Korea",-,0,0,0,40,7,34,81,0,0,0,53,9,40,102,777
2020,Kuwait,-,9,43,64,109,0,290,515,5,35,69,104,5,631,849,2852
2020,"Lao People's Dem. Rep.",-,0,0,0,0,7,0,7,0,0,0,30,12,15,57,7128
2020,Liberia,-,92,205,195,1086,55,78,1711,97,204,210,1434,57,135,2137,8287
2020,Libya,-,176,380,228,974,26,696,2480,183,431,227,2253,65,1591,4750,301223
2020,"Saint Lucia",-,0,0,0,0,0,12,12,0,0,0,0,0,25,25,809
2020,Lebanon,-,273,453,333,4744,456,624,6883,250,589,422,1766,100,934,4061,18205
2020,Lesotho,-,6,0,0,20,0,0,26,0,0,0,0,0,0,0,44
2020,Liechtenstein,-,0,0,0,0,0,0,0,0,0,0,0,0,0,0,5
2020,"Sri Lanka",-,192,326,202,1986,449,31646,34801,214,287,236,6131,410,32712,39990,182738
2020,Lithuania,-,0,0,0,0,0,0,0,0,0,0,5,0,17,22,136
2020,Luxembourg,-,0,0,0,5,0,0,5,0,0,0,0,0,0,0,5
2020,Latvia,-,0,5,0,0,0,0,5,0,0,0,12,0,5,17,235
2020,"China, Macao SAR",-,0,0,0,0,0,0,0,0,0,0,0,0,5,5,44
2020,Madagascar,-,0,0,0,14,0,89,103,0,7,0,0,0,187,194,606
2020,Martinique,-,0,0,0,0,0,0,0,0,0,0,0,0,0,0,5
2020,Mauritania,-,253,3807,3817,6430,811,747,15865,297,3994,3758,6209,935,1635,16828,47183
2020,"North Macedonia",-,81,130,113,545,35,193,1097,72,154,108,465,45,346,1190,3301
2020,"Rep. of Moldova",-,76,96,79,382,17,497,1147,89,138,63,387,12,979,1668,7716
2020,Maldives,-,0,0,5,0,0,0,5,0,0,0,0,0,7,7,101
2020,Mexico,-,236,367,239,2195,0,197,3234,264,370,269,3342,0,339,4584,127126
2020,"Marshall Islands",-,0,0,0,0,0,16,16,0,0,0,0,0,34,34,57
2020,Mali,-,11165,19783,13025,33676,2888,188027,268564,10972,19715,12537,23488,2821,150770,220303,508681
2020,Malaysia,-,0,5,5,17,0,127,154,5,7,0,22,0,269,303,22532
2020,Malawi,-,14,28,22,445,0,38,547,12,25,22,1403,20,62,1544,2682
2020,Mongolia,-,53,60,21,232,20,315,701,50,69,32,154,16,496,817,6412
2020,Morocco,-,118,105,39,724,20,1631,2637,122,103,74,1203,20,3254,4776,13108
2020,Mozambique,-,134,253,156,467,54,5,1069,143,244,150,359,29,17,942,676793
2020,Malta,-,0,0,0,0,0,0,0,0,0,0,0,0,0,0,15
2020,Montenegro,-,11,21,21,156,19,24,252,17,28,22,124,11,13,215,1164
2020,Mauritius,-,0,5,0,19,0,35,59,5,0,5,16,0,84,110,514
2020,Myanmar,-,108554,137636,90787,347484,26151,38270,748882,109146,142294,96561,349196,28619,32918,758734,1513923
2020,Namibia,-,5,0,0,17,0,238,260,0,5,0,13,0,495,513,1298
2020,Nepal,-,6,0,0,120,0,419,545,5,6,5,312,0,948,1276,18188
2020,"Netherlands (Kingdom of the)",-,13,0,0,7,0,5,25,6,5,0,5,0,0,16,134
2020,Niger,-,10887,25433,11477,32707,4132,189,84825,9533,21952,9659,28722,3498,388,73752,355740
2020,Nicaragua,-,76,124,74,854,22,2711,3861,102,121,84,1746,16,3336,5405,72451
2020,Nigeria,-,29368,49669,22054,76478,5871,1387995,1571435,28446,47900,20596,64089,5705,1236044,1402780,3036479
2020,Niue,-,0,0,0,0,0,0,0,0,0,0,0,0,0,0,25
2020,Norway,-,0,0,0,0,0,0,0,9,0,0,0,0,0,9,20
2020,Nauru,-,0,0,0,0,0,0,0,0,0,0,0,0,0,0,21
2020,"New Zealand",-,0,0,0,0,0,0,0,0,0,0,8,0,0,8,67
2020,Oman,-,0,5,0,8,0,7,20,0,0,5,0,0,20,25,117
2020,Pakistan,-,16368,19884,10945,43220,4186,4101,98704,17699,23251,12596,57431,5621,15594,132192,296342
2020,Panama,-,23,0,0,0,0,43,66,30,0,0,5,0,52,87,385
2020,Paraguay,-,0,10,0,15,0,245,270,0,0,5,22,0,300,327,987
2020,Peru,-,32,30,0,402,85,2424,2973,36,0,38,430,97,2989,3590,513770
2020,Philippines,-,12,12,11,139,6,76893,77073,9,28,5,49,0,74117,74208,285293
2020,"Papua New Guinea",-,0,0,0,0,0,0,0,0,0,0,0,0,0,0,15160
2020,Poland,-,0,0,5,34,133,73,245,0,0,6,121,327,111,565,1962
2020,Portugal,-,7,0,0,0,0,0,7,0,0,0,7,0,0,7,387
2020,Qatar,-,0,0,0,0,0,5,5,0,0,0,5,0,8,13,71
2020,Romania,-,5,36,31,194,32,91,389,22,31,30,232,73,78,466,5063
2020,"South Africa",-,38,79,51,309,11,102,590,19,82,45,194,11,190,541,3710
2020,"Russian Federation",-,1042,2362,1618,6514,650,5776,17962,1117,2599,1734,6046,430,8228,20154,97141
2020,Rwanda,-,2719,5612,4960,15146,921,105213,134571,2992,5722,4989,16866,1374,104159,136102,286205
2020,"El Salvador",-,388,572,399,3565,67,42416,47407,425,647,516,5790,74,39047,46499,286908
2020,"Saudi Arabia",-,16,41,15,134,0,122,328,19,27,40,174,0,178,438,3278
2020,"Serbia and Kosovo: S/RES/1244 (1999)",-,1164,1502,1549,7266,2292,1418,15191,1248,1549,1597,8220,2186,2247,17047,250238
2020,Senegal,-,130,668,562,1902,320,1422,5004,145,639,625,3943,308,2798,8458,29772
2020,Seychelles,-,0,0,0,0,0,0,0,0,0,0,0,0,5,5,15
2020,Singapore,-,0,0,0,0,0,0,0,0,0,8,0,0,9,17,111
2020,"Sierra Leone",-,200,391,327,1873,104,451,3346,208,372,336,2985,110,969,4980,14118
2020,"Solomon Islands",-,0,0,0,6,0,0,6,0,0,0,7,0,0,7,304
2020,Somalia,-,427881,398344,228213,780131,28763,5303,1868635,449259,414167,229479,761980,29155,8852,1892892,3833714
2020,Spain,-,0,6,12,5,0,5,28,0,0,21,5,7,0,33,346
2020,"Viet Nam",-,63,116,100,725,228,1206,2438,83,129,101,1063,302,2628,4306,326236
2020,"Saint Kitts and Nevis",-,0,0,0,0,0,5,5,0,0,0,0,0,8,8,72
2020,"Sao Tome and Principe",-,0,5,0,11,0,0,16,0,0,0,7,0,0,7,51
2020,Sudan,-,67887,89651,62154,179381,14409,1445357,1858839,69989,91858,63127,149609,12305,1112520,1499408,3410204
2020,Suriname,-,0,0,0,0,0,41,41,0,0,0,0,0,39,39,163
2020,"South Sudan",-,157987,294793,190535,460812,44560,33,1148720,161099,301588,208558,345408,27281,81,1044015,4043953
2020,Slovakia,-,0,0,0,26,19,67,112,0,0,0,43,35,80,158,1577
2020,Slovenia,-,0,0,0,0,0,0,0,0,0,0,0,6,0,6,22
2020,Eswatini,-,0,0,0,28,0,0,28,0,0,18,25,0,10,53,279
2020,Sweden,-,0,8,0,0,0,0,8,0,0,0,0,0,5,5,43
2020,Switzerland,-,0,0,0,0,0,0,0,0,0,0,0,0,0,0,21
2020,"Syrian Arab Rep.",-,425234,600446,378231,1440559,104418,17223,2966111,438389,645510,430685,1786858,93695,32889,3428026,13519788
2020,"United Rep. of Tanzania",-,70,30,25,306,0,152,583,48,80,18,774,0,202,1122,2624
2020,"Turks and Caicos Islands",-,5,0,0,0,0,0,5,0,0,0,0,0,0,0,19
2020,Thailand,-,0,5,0,81,0,34,120,0,0,12,52,0,76,140,3934
2020,Tajikistan,-,174,261,122,579,16,177,1329,204,255,133,826,14,277,1709,4678
2020,Turkmenistan,-,14,20,21,84,0,23,162,15,29,16,81,0,43,184,1083
2020,Timor-Leste,-,0,0,0,0,0,0,0,0,0,0,7,0,6,13,335
2020,Togo,-,126,305,333,1481,123,249,2617,140,314,266,2666,202,621,4209,11034
2020,Tonga,-,0,0,0,0,0,0,0,0,0,0,0,0,0,0,762
2020,"Trinidad and Tobago",-,0,0,0,10,0,57,67,0,0,0,10,0,101,111,1102
2020,Tunisia,-,39,48,31,263,7,329,717,46,34,26,585,12,814,1517,4476
2020,Türkiye,-,1803,3466,2960,19463,2758,6146,36596,1900,3761,3119,32391,2808,11479,55458,138274
2020,"United Arab Emirates",-,5,7,5,14,0,5,36,0,8,0,21,0,8,37,362
2020,Uganda,-,178,316,186,2278,39,1199901,1202898,163,249,207,5131,91,1152732,1158573,2370504
2020,Ukraine,-,151,260,169,1117,265,1321716,1323678,158,299,155,988,128,1040744,1042472,2410587
2020,Uruguay,-,0,0,0,5,0,104,109,7,0,0,10,0,126,143,450
2020,"United States of America",-,607,220,100,70,10,185,1192,640,272,101,96,23,180,1312,2847
2020,Uzbekistan,-,15,19,27,157,14,671,903,17,46,26,135,7,1024,1255,8283
2020,Vanuatu,-,0,0,0,0,0,0,0,0,0,0,0,0,0,0,158
2020,"Holy See",-,0,0,0,0,0,0,0,0,0,0,0,0,0,0,12
2020,"Saint Vincent and the Grenadines",-,0,0,0,0,0,7,7,0,0,0,5,0,14,19,780
2020,"Venezuela (Bolivarian Republic of)",-,117207,145835,169826,1100280,74519,214438,1822105,108069,140273,148943,975798,64684,209010,1646777,5996996
2020,Samoa,-,0,0,0,0,0,0,0,0,0,0,0,0,5,5,133
2020,"Western Sahara",-,0,0,0,24,0,135,159,0,0,0,92,0,302,394,117968
2020,Yemen,-,281767,403183,402541,891318,80915,838,2060562,241709,443421,402842,825909,81130,2195,1997206,4069343
2020,Zambia,-,0,5,25,171,0,21,222,0,0,5,106,0,38,149,732
2020,Zimbabwe,-,94,311,484,7928,117,257,9191,100,323,425,7956,148,407,9359,23321
2020,Stateless,-,141358,112674,66176,407205,38773,281056,1047242,148050,131916,61517,326284,43937,307135,1018839,3046291
2020,Tibetan,-,0,0,0,0,0,6897,6897,0,0,0,7,0,5649,5656,12568
2020,Anguilla,-,0,0,0,0,0,0,0,0,0,0,0,0,0,0,5
2020,Guadeloupe,-,0,0,0,0,0,0,0,0,0,0,0,0,0,0,86
2020,"Curacao ",-,0,0,0,0,0,0,0,0,0,0,0,0,0,0,35
2020,"Unknown ",-,3192,2956,2285,12658,679,13019,34789,3331,3303,2843,22279,992,17672,50420,327323
2021,Afghanistan,-,580700,658485,478530,1332616,128756,18196,3197283,590640,675840,518799,1469392,157696,126727,3539094,7022010
2021,Albania,-,144,323,218,1201,49,830,2765,199,346,220,1294,60,1127,3246,42178
2021,Algeria,-,98,152,74,731,21,180,1256,126,161,130,2415,59,1207,4098,12907
2021,Andorra,-,0,0,0,0,0,0,0,0,0,0,0,0,0,0,5
2021,Angola,-,1417,2598,1803,5751,590,195,12354,1458,2484,1863,4835,1032,221,11893,43887
2021,"Antigua and Barbuda",-,0,0,0,22,0,0,22,0,0,7,11,0,0,18,160
2021,Egypt,-,272,528,392,1416,120,272,3000,222,549,392,2877,103,4551,8694,48596
2021,Argentina,-,41,10,5,103,0,15,174,26,9,10,126,8,22,201,1903
2021,Armenia,-,143,261,180,1483,384,393,2844,171,300,252,1619,287,463,3092,21546
2021,Australia,-,0,12,0,0,0,0,12,0,0,6,0,0,0,6,37
2021,Austria,-,0,5,0,0,0,0,5,5,0,0,0,0,0,5,28
2021,Azerbaijan,-,224,451,308,2368,564,278,4193,245,544,413,2396,380,388,4366,699552
2021,Bahrain,-,0,9,12,15,5,0,41,15,6,5,87,5,5,123,553
2021,Barbados,-,5,15,0,60,0,0,80,0,13,5,34,0,0,52,356
2021,Burundi,-,33388,37741,25804,82052,4529,284,183798,33005,38101,26453,103593,4386,350,205888,400138
2021,Belgium,-,5,0,0,7,5,0,17,0,0,0,8,0,0,8,123
2021,Benin,-,26,11,16,149,0,36,238,15,18,15,303,5,85,441,2112
2021,Bangladesh,-,67,138,80,899,38,150,1372,58,147,117,26905,121,9603,36951,263524
2021,Bahamas,-,27,45,33,233,0,24,362,30,47,33,183,0,20,313,1394
2021,Bhutan,-,125,370,346,1764,352,0,2957,126,387,417,1976,533,0,3439,7189
2021,"Burkina Faso",-,128037,230161,131199,327670,32354,62,849483,129835,235454,135190,232793,28259,315,761846,1618849
2021,Belarus,-,10,34,33,208,22,783,1090,11,36,38,220,24,1210,1539,11431
2021,"Bolivia (Plurinational State of)",-,6,30,18,113,6,0,173,11,11,10,114,11,5,162,2379
2021,Botswana,-,0,0,5,65,0,0,70,0,9,5,27,0,0,41,335
2021,Brazil,-,1976,281,36,192,5,13722,16212,2080,320,21,247,0,13128,15796,54990
2021,"Brunei Darussalam",-,0,0,0,0,0,0,0,0,0,0,0,0,0,0,5
2021,"Bosnia and Herzegovina",-,104,177,102,836,260,47280,48759,112,144,102,690,183,49219,50450,116306
2021,Bulgaria,-,0,9,0,32,8,0,49,0,5,0,39,34,0,78,800
2021,Belize,-,5,19,0,10,0,0,34,16,13,10,19,0,0,58,450
2021,Cambodia,-,17,14,42,262,14,0,349,16,30,30,241,29,0,346,12965
2021,Canada,-,0,0,17,7,0,0,24,0,0,14,5,0,0,19,186
2021,"Central African Rep.",-,51384,97445,57890,172605,12657,415094,807075,51671,96757,56137,135328,11067,276749,627709,1446016
2021,"Cayman Islands",-,0,0,0,0,0,0,0,0,0,0,0,0,0,0,5
2021,Chad,-,798,1379,842,2717,248,51,6035,804,1351,823,3197,226,126,6527,532945
2021,China,-,165,182,111,2710,160,374,3702,182,215,150,3517,224,420,4708,288708
2021,Chile,-,3736,129,18,194,43,29,4149,3665,108,12,183,69,21,4058,10045
2021,Cameroon,-,4884,9144,5340,22955,1774,789,44886,4951,8994,5046,20181,1117,1284,41573,1080788
2021,Congo,-,107,238,565,5234,130,95,6369,56,281,504,7548,173,110,8672,161562
2021,"Dem. Rep. of the Congo",-,74702,106305,74398,230049,15156,1857,502467,75585,106460,75231,229807,12200,1850,501133,6479683
2021,Comoros,-,0,10,5,174,0,17,206,0,0,7,369,0,21,397,3503
2021,Colombia,-,78377,286831,385096,2112814,407383,127438,3397939,83011,299325,401892,2208104,426202,133766,3552300,8208726
2021,"Costa Rica",-,45,15,21,32,0,950,1063,39,16,5,49,0,913,1022,3087
2021,Cuba,-,245,505,302,9940,247,164,11403,185,490,358,17615,281,188,19117,96788
2021,"Cabo Verde",-,0,5,5,0,0,0,10,0,0,0,5,0,0,5,283
2021,Cyprus,-,0,0,0,0,0,0,0,0,0,0,5,0,0,5,20
2021,Czechia,-,7,5,7,58,124,0,201,0,13,0,79,202,0,294,919
2021,Denmark,-,0,0,0,0,0,0,0,0,0,0,8,0,0,8,33
2021,Djibouti,-,6,30,6,86,10,49,187,5,26,28,127,0,41,227,4902
2021,Dominica,-,0,0,0,5,0,0,5,0,5,0,10,0,0,15,178
2021,"Dominican Rep.",-,5,34,21,649,5,11,725,0,33,23,577,5,6,644,5277
2021,Ecuador,-,55,51,25,169,0,20,320,60,52,31,213,5,28,389,29111
2021,"Equatorial Guinea",-,0,5,5,14,0,0,24,0,0,5,5,8,0,18,403
2021,Eritrea,-,15663,29753,24625,123449,7420,3406,204316,16650,30635,27543,137100,8278,8807,229013,599637
2021,Estonia,-,0,0,0,0,0,0,0,0,0,0,16,0,0,16,319
2021,Ethiopia,-,9961,14063,10111,61775,2680,506,99096,10706,15116,11244,118283,3663,678,159690,4023479
2021,"French Guiana",-,33,5,0,0,0,0,38,34,0,0,0,0,0,34,96
2021,Fiji,-,0,0,0,0,0,0,0,0,0,0,6,0,0,6,3411
2021,Finland,-,0,0,0,0,0,0,0,0,0,0,0,0,0,0,5
2021,France,-,5,8,6,17,0,5,41,5,16,5,22,0,0,48,318
2021,Gabon,-,7,5,6,46,0,24,88,0,10,0,42,0,21,73,1522
2021,Gambia,-,159,82,40,646,0,81,1008,133,75,104,2191,11,1047,3561,16832
2021,Palestinian,-,484,1129,907,4893,942,35840,44195,444,1168,1061,6923,1025,37398,48019,114335
2021,"United Kingdom of Great Britain and Northern Ireland",-,5,8,0,5,0,0,18,14,11,0,12,0,0,37,378
2021,Georgia,-,9611,18259,12542,79859,36442,1633,158346,10122,19152,13661,74527,22704,1218,141384,316558
2021,Germany,-,0,0,0,15,0,0,15,0,0,0,14,0,0,14,307
2021,Ghana,-,152,951,1341,3761,438,158,6801,111,988,1349,3317,230,714,6709,23445
2021,Guinea-Bissau,-,22,5,5,61,0,5,98,10,6,19,223,5,72,335,4585
2021,Greece,-,5,0,0,0,6,0,11,0,0,5,13,33,0,51,258
2021,Grenada,-,0,0,0,0,0,0,0,0,0,0,9,0,0,9,149
2021,Guatemala,-,22162,32437,31419,135585,18699,40,240342,20889,31355,41187,165737,17583,46,276797,742971
2021,Guinea,-,779,407,178,2801,18,591,4774,754,335,933,6438,16,1438,9914,61001
2021,Guyana,-,15,6,5,37,0,0,63,8,10,10,26,0,0,54,7033
2021,Haiti,-,571,1652,848,24411,151,80,27713,533,1722,836,35281,108,107,38587,184404
2021,"China, Hong Kong SAR",-,0,14,0,5,0,84,103,0,7,0,15,0,84,106,912
2021,Honduras,-,16367,29316,21392,93610,8317,183,169185,17973,25227,21348,99103,7670,226,171547,517697
2021,Croatia,-,0,0,12,103,57,111,283,0,0,0,82,101,95,278,18348
2021,Hungary,-,47,43,29,277,67,58,521,83,72,26,337,144,57,719,5261
2021,Iceland,-,0,0,0,0,0,0,0,0,0,0,7,0,0,7,12
2021,"Cote d'Ivoire",-,2134,3360,2368,11393,825,522,20602,2147,3279,2385,12084,470,1006,21371,72700
2021,India,-,267,413,230,4163,105,249,5427,310,531,397,9885,203,1394,12720,92845
2021,Indonesia,-,24,41,5,1082,5,9,1166,19,35,5,49,5,8,121,20110
2021,Ireland,-,0,0,12,5,0,0,17,0,7,0,5,0,0,12,146
2021,"Iran (Islamic Rep. of)",-,1930,3573,3002,29845,2469,1702,42521,1850,3830,3438,46095,3309,3201,61723,212221
2021,Iraq,-,15076,36545,28102,110950,12578,3148,206399,15907,39120,31121,139032,11154,6787,243121,1815365
2021,Israel,-,0,5,0,52,0,5,62,6,14,5,57,0,5,87,1260
2021,Italy,-,6,16,5,33,0,0,60,5,7,5,33,0,0,50,700
2021,Jamaica,-,12,9,16,234,7,21,299,8,14,12,387,5,11,437,4724
2021,Jordan,-,53,157,79,1420,54,143,1906,73,151,122,828,12,237,1423,9649
2021,Japan,-,0,0,8,11,0,0,19,0,0,5,9,0,0,14,173
2021,Kazakhstan,-,6,27,15,139,28,123,338,10,32,15,159,6,152,374,9123
2021,Kenya,-,230,578,373,2205,184,74,3644,275,598,406,1870,172,61,3382,171411
2021,Kyrgyzstan,-,21,46,31,127,13,110,348,20,38,27,129,5,86,305,5820
2021,Kiribati,-,0,0,0,0,0,0,0,0,0,0,0,0,0,0,5
2021,"Rep. of Korea",-,0,5,5,21,5,10,46,0,5,5,25,0,0,35,1010
2021,"Dem. People's Rep. of Korea",-,0,0,0,43,7,5,55,0,0,0,59,11,10,80,636
2021,Kuwait,-,5,71,50,168,5,15,314,6,42,85,129,0,20,282,3564
2021,"Lao People's Dem. Rep.",-,0,0,0,0,6,0,6,0,0,0,29,13,0,42,7252
2021,Liberia,-,122,209,195,1151,61,30,1768,92,183,219,1443,72,63,2072,8520
2021,Libya,-,160,446,255,1076,28,185,2150,198,484,265,2262,76,577,3862,203904
2021,"Saint Lucia",-,0,0,5,16,0,0,21,0,0,5,6,0,0,11,548
2021,Lebanon,-,1071,1166,575,7773,752,286,11623,1119,1247,587,2487,180,471,6091,26597
2021,Lesotho,-,7,0,0,18,0,0,25,0,0,0,5,0,0,5,47
2021,Liechtenstein,-,0,0,0,0,0,5,5,0,0,0,0,0,0,0,10
2021,"Sri Lanka",-,162,320,242,1956,464,30232,33376,170,308,247,5773,479,28937,35914,172104
2021,Lithuania,-,0,0,7,0,0,0,7,0,0,0,5,0,7,12,168
2021,Latvia,-,0,0,0,10,0,0,10,0,0,0,11,0,0,11,242
2021,"China, Macao SAR",-,0,0,0,0,0,0,0,0,0,0,0,0,0,0,34
2021,Madagascar,-,0,0,0,34,0,10,44,5,10,5,14,0,0,34,808
2021,Mauritania,-,1205,3427,2736,6733,794,85,14980,1309,3498,2628,6473,917,130,14955,47984
2021,"North Macedonia",-,214,330,202,1038,56,120,1960,255,398,251,988,74,173,2139,5945
2021,"Rep. of Moldova",-,143,212,155,738,53,358,1659,168,228,166,653,51,299,1565,9071
2021,Maldives,-,0,0,5,0,0,0,5,0,0,0,0,0,0,0,101
2021,Mexico,-,229,426,283,2633,37,33,3641,267,411,298,3837,23,51,4887,134339
2021,"Marshall Islands",-,0,0,0,0,0,0,0,0,0,0,0,0,0,0,7
2021,Mali,-,11852,23186,15490,39540,3235,192832,286135,11704,22810,15057,29017,3190,158587,240365,557815
2021,Malaysia,-,0,0,16,23,0,0,39,0,10,0,37,0,5,52,22037
2021,Malawi,-,10,30,19,418,0,0,477,11,20,20,1320,30,0,1401,2531
2021,Mongolia,-,32,64,28,222,22,131,499,46,65,44,151,16,109,431,7186
2021,Morocco,-,124,124,42,761,26,348,1425,137,133,75,1210,19,2223,3797,18116
2021,Mozambique,-,140,253,157,481,56,5,1092,157,239,161,359,29,5,950,753768
2021,Malta,-,0,0,0,0,0,0,0,0,0,0,0,0,0,0,12
2021,Montenegro,-,32,23,25,169,19,20,288,20,32,22,130,12,18,234,1432
2021,Mauritius,-,10,5,0,22,0,9,46,5,5,0,24,0,0,34,549
2021,Myanmar,-,115179,146547,97091,368709,28413,166540,922479,118459,151203,104905,371752,30232,165488,942039,1892414
2021,Namibia,-,10,9,0,50,0,0,69,0,11,5,27,0,0,43,1396
2021,Nepal,-,5,0,5,94,0,61,165,5,15,8,233,0,160,421,18721
2021,"Netherlands (Kingdom of the)",-,9,0,6,7,0,0,22,5,15,0,10,0,0,30,151
2021,Niger,-,26126,45473,24580,57686,5095,40,159000,21112,36221,19400,43119,5128,139,125119,285908
2021,Nicaragua,-,837,3029,2457,67753,9355,89,83520,604,2297,2943,58374,7195,90,71503,204450
2021,Nigeria,-,28777,56020,26324,82902,6582,2325,202930,27616,53531,24062,66378,6299,3320,181206,3551699
2021,Niue,-,0,0,0,0,0,0,0,0,0,0,0,0,0,0,11
2021,Norway,-,5,0,0,0,0,0,5,0,5,0,7,0,0,12,28
2021,Nauru,-,0,0,0,0,0,0,0,0,0,0,0,0,0,0,21
2021,"New Zealand",-,0,5,0,13,0,0,18,0,0,0,20,6,0,26,102
2021,Oman,-,0,5,0,8,0,0,13,0,5,0,0,0,0,5,124
2021,Pakistan,-,16297,19883,11027,43358,4235,456,95256,17592,23202,12686,55389,5708,14210,128787,1519140
2021,Panama,-,68,15,5,0,0,7076,7164,65,23,5,12,0,7445,7550,15151
2021,Paraguay,-,5,5,5,29,0,9,53,0,0,0,24,10,0,34,1227
2021,Peru,-,87,43,33,503,100,279,1045,88,47,48,493,109,304,1089,512920
2021,Philippines,-,6,16,5,191,8,53711,53937,9,24,15,121,0,51586,51755,294911
2021,"Papua New Guinea",-,0,0,0,0,0,0,0,0,0,0,0,0,0,0,25143
2021,Poland,-,7,6,6,56,139,0,214,5,10,5,103,335,0,458,1943
2021,Portugal,-,0,14,0,12,0,0,26,0,0,0,18,0,0,18,465
2021,Qatar,-,0,0,0,0,0,0,0,0,0,0,5,0,0,5,82
2021,Romania,-,17,35,16,171,29,38,306,16,25,36,208,72,39,396,5869
2021,"South Africa",-,41,86,69,306,22,13,537,24,61,59,214,10,17,385,4205
2021,"Russian Federation",-,779,2009,1537,6041,638,1349,12353,815,2264,1643,5554,431,1572,12279,111506
2021,Rwanda,-,25162,33328,24026,51595,3056,234,137401,22069,34670,25150,51586,4026,229,137730,293471
2021,"El Salvador",-,1030,1846,1157,11257,271,40518,56079,1130,2013,1407,24048,506,35361,64465,332761
2021,"Saudi Arabia",-,10,60,26,187,0,45,328,27,19,44,244,0,24,358,3740
2021,"Serbia and Kosovo: S/RES/1244 (1999)",-,1173,1473,1495,6559,2125,404,13229,1245,1520,1582,7528,1973,616,14464,250404
2021,Senegal,-,118,664,581,2000,323,130,3816,125,660,711,4817,321,837,7471,32595
2021,Seychelles,-,0,0,0,0,0,0,0,0,0,0,0,0,0,0,14
2021,Singapore,-,0,0,5,0,0,0,5,0,0,7,0,0,0,7,134
2021,"Sierra Leone",-,142,240,204,1250,16,75,1927,174,173,228,1918,20,289,2802,12305
2021,"Solomon Islands",-,0,0,0,6,0,0,6,0,0,0,7,0,0,7,1352
2021,Somalia,-,432316,398587,227544,781999,28036,2723,1871205,454846,415483,230877,718657,29108,4450,1853421,3803830
2021,Spain,-,0,0,18,17,5,5,45,0,0,23,36,0,5,64,478
2021,"Viet Nam",-,67,122,96,802,253,34,1374,68,131,107,1058,317,84,1765,328150
2021,"Saint Kitts and Nevis",-,0,0,0,0,0,0,0,0,0,0,6,0,0,6,79
2021,"Sao Tome and Principe",-,0,0,0,6,0,0,6,0,0,0,0,0,0,0,31
2021,Sudan,-,170185,364796,264135,915148,103412,306,1817982,184288,455646,269001,1023419,122586,806,2055746,3937345
2021,Suriname,-,0,0,0,5,0,5,10,0,0,0,0,0,10,10,140
2021,"South Sudan",-,155456,311958,208247,506956,48550,14,1231181,158038,317666,227411,399825,32362,38,1135340,4635106
2021,Slovakia,-,9,11,5,47,17,15,104,15,13,0,69,35,26,158,1597
2021,Slovenia,-,0,0,0,0,0,0,0,0,5,0,0,6,0,11,27
2021,Eswatini,-,0,0,5,38,0,0,43,0,0,16,30,0,0,46,255
2021,Sweden,-,0,0,0,9,0,0,9,0,0,0,0,0,0,0,52
2021,Switzerland,-,0,0,0,0,0,0,0,0,0,0,0,0,0,0,21
2021,"Syrian Arab Rep.",-,407575,641988,378133,1476947,108962,6104,3019709,432981,681236,411840,1838313,97771,23454,3485595,13857059
2021,"United Rep. of Tanzania",-,65,73,26,360,5,40,569,49,96,46,747,5,46,989,2626
2021,"Turks and Caicos Islands",-,5,0,0,0,0,0,5,0,0,0,0,0,0,0,19
2021,Thailand,-,0,5,0,79,5,10,99,0,0,6,54,6,5,71,3411
2021,Tajikistan,-,133,198,110,475,17,155,1088,131,208,103,705,18,202,1367,4435
2021,Turkmenistan,-,15,15,17,69,0,26,142,11,23,16,76,5,27,158,1285
2021,Timor-Leste,-,0,0,0,0,0,0,0,0,0,0,7,0,0,7,379
2021,Togo,-,108,280,292,1511,138,51,2380,109,260,284,2486,227,245,3611,10994
2021,Tonga,-,0,0,0,0,0,0,0,0,0,0,0,0,0,0,844
2021,"Trinidad and Tobago",-,0,5,0,25,0,2469,2499,0,11,0,26,0,2148,2185,5988
2021,Tunisia,-,40,52,41,308,11,270,722,54,55,50,742,14,1472,2387,6222
2021,Türkiye,-,1968,4526,3098,17904,2266,2443,32205,2114,4791,3389,32769,2685,5492,51240,151468
2021,"United Arab Emirates",-,0,5,19,7,0,0,31,0,13,5,28,0,0,46,375
2021,Uganda,-,230,363,265,2692,39,1238912,1242501,237,290,269,5255,109,1190294,1196454,2448627
2021,Ukraine,-,212,459,260,1880,394,1231473,1234678,238,508,285,1570,198,1049162,1051961,2325793
2021,Uruguay,-,20,0,6,14,0,5,45,23,5,0,16,0,0,44,693
2021,"United States of America",-,337,183,94,103,21,22,760,302,196,88,139,11,16,752,2094
2021,Uzbekistan,-,15,14,22,130,15,226,422,5,41,20,97,7,489,659,7960
2021,Vanuatu,-,0,0,0,0,0,0,0,0,0,0,0,0,0,0,172
2021,"Holy See",-,0,0,0,0,0,0,0,0,0,0,0,0,0,0,12
2021,"Saint Vincent and the Grenadines",-,0,5,0,23,5,0,33,0,0,0,15,0,0,15,552
2021,"Venezuela (Bolivarian Republic of)",-,105738,171573,188693,1453404,89645,705659,2714712,112307,179262,183571,1293851,70495,666904,2506390,6966720
2021,Samoa,-,0,0,0,0,0,0,0,0,0,0,0,0,0,0,165
2021,"Western Sahara",-,5,0,0,27,0,0,32,0,0,0,88,0,0,88,117735
2021,Yemen,-,344866,389100,431416,955199,86697,313,2207591,344837,432166,431764,841455,86984,1407,2138613,4361839
2021,Zambia,-,0,0,18,178,0,0,196,0,0,10,102,0,0,112,749
2021,Zimbabwe,-,74,230,434,7654,158,21,8571,83,223,357,7700,186,20,8569,21765
2021,Stateless,-,138861,116450,68862,427030,40117,278699,1070019,143588,134216,63972,342497,43654,270585,998512,3143868
2021,Tibetan,-,0,0,0,0,0,6897,6897,0,0,0,0,0,5643,5643,12593
2021,Anguilla,-,0,0,0,0,0,0,0,0,0,0,0,0,0,0,5
2021,Aruba,-,0,0,0,0,0,3163,3163,0,0,0,0,0,2837,2837,6000
2021,Guadeloupe,-,0,0,0,0,0,0,0,0,0,0,0,0,0,0,88
2021,"Curacao ",-,0,0,0,0,0,2979,2979,0,0,0,0,0,2247,2247,5261
2021,"Unknown ",-,3207,3544,2585,16223,1534,105042,132135,3291,3855,3101,26628,1609,110764,149248,357646
2022,Afghanistan,-,766188,945375,684775,1999126,184505,149889,4729858,780769,976994,746835,2211297,240836,242046,5198777,10179326
2022,Albania,-,156,317,281,1576,57,6689,9076,176,377,250,1802,92,6672,9369,55271
2022,Algeria,-,131,186,110,988,38,2065,3518,143,207,195,3898,70,4406,8919,16764
2022,Andorra,-,0,0,5,0,0,0,5,0,0,0,0,0,0,0,10
2022,Angola,-,1092,2121,1622,5027,426,3629,13917,1105,2034,1611,4166,768,3971,13655,41859
2022,"Antigua and Barbuda",-,0,0,5,25,0,0,30,0,6,8,26,0,0,40,116
2022,Egypt,-,192,500,469,1820,174,1173,4328,161,490,550,3871,229,11721,17022,52386
2022,Argentina,-,79,36,15,150,5,462,747,48,39,23,212,5,481,808,2470
2022,Armenia,-,168,328,272,2671,575,4307,8321,180,410,402,3158,414,4572,9136,28347
2022,Australia,-,0,0,0,5,0,0,5,0,0,0,11,0,10,21,61
2022,Austria,-,0,5,5,0,0,5,15,0,0,0,0,0,8,8,58
2022,Azerbaijan,-,177,373,305,2726,632,3069,7282,167,444,375,3339,428,3816,8569,706635
2022,Bahrain,-,5,10,11,11,5,16,58,0,0,12,77,5,11,105,470
2022,Barbados,-,6,22,30,188,0,0,246,5,19,16,91,0,0,131,457
2022,Burundi,-,32672,37218,25027,79993,4456,3289,182655,32569,37845,25849,100262,4496,4031,205052,391745
2022,Belgium,-,0,7,0,12,0,5,24,0,0,5,6,0,5,16,114
2022,Benin,-,36,27,16,176,5,198,458,24,22,29,397,10,273,755,2218
2022,Bangladesh,-,83,160,178,1381,89,2243,4134,63,174,248,14840,164,25743,41232,260122
2022,Bahamas,-,44,131,70,506,7,0,758,45,105,70,355,0,0,575,1991
2022,Bhutan,-,125,370,346,1769,352,37,2999,126,387,417,1989,533,133,3585,7153
2022,"Burkina Faso",-,157442,274499,159168,391766,41704,566,1025145,157535,275895,161370,286014,35288,1103,917205,1947840
2022,Belarus,-,36,101,65,584,72,1195,2053,33,103,55,622,52,1394,2259,19994
2022,"Bolivia (Plurinational State of)",-,8,39,18,249,10,138,462,13,41,21,254,24,99,452,2902
2022,Botswana,-,5,31,6,251,0,8,301,15,18,18,127,0,0,178,795
2022,Brazil,-,3803,2442,1092,8457,16,1190,17000,3975,2608,1147,9596,52,1165,18543,55497
2022,"Brunei Darussalam",-,0,0,0,0,0,0,0,0,0,0,0,0,0,0,14
2022,"Bosnia and Herzegovina",-,77,158,96,808,258,50876,52273,87,132,97,702,181,53060,54259,117280
2022,Bulgaria,-,5,8,12,80,10,148,263,0,19,5,103,32,312,471,1151
2022,Belize,-,10,27,18,76,0,0,131,14,45,24,71,0,0,154,546
2022,Cambodia,-,12,23,33,266,16,5254,5604,13,25,22,226,17,5564,5867,12678
2022,Canada,-,5,11,11,24,0,11,62,0,21,7,30,0,33,91,404
2022,"Central African Rep.",-,48572,97732,60266,176767,13140,265937,662414,49051,97516,58402,136650,11468,255671,608758,1280546
2022,"Cayman Islands",-,0,0,0,0,0,0,0,0,0,0,0,0,0,0,5
2022,Chad,-,726,1381,894,2886,256,1335,7478,735,1392,929,3817,251,2254,9378,502858
2022,China,-,156,339,371,8452,652,6495,16465,147,379,384,10900,530,8651,20991,277854
2022,Chile,-,4503,350,44,311,48,335,5591,4445,321,31,312,76,342,5527,15505
2022,Cameroon,-,7849,14050,8096,31302,2665,16328,80290,7832,13787,7554,24849,1570,16705,72297,1158366
2022,Congo,-,2032,2916,1709,10935,2129,3137,22858,1980,2849,1811,11048,1505,3306,22499,49884
2022,"Dem. Rep. of the Congo",-,82229,107226,74890,226609,14973,20319,526246,82995,107399,75567,221974,12423,21612,521970,6625613
2022,Comoros,-,0,0,0,10,0,787,797,5,0,0,24,0,1141,1170,2692
2022,Colombia,-,73499,290377,398943,2323606,469074,668803,4224302,66706,263799,362421,2121543,427120,644917,3886506,8751951
2022,"Costa Rica",-,143,184,158,1045,349,64,1943,133,217,159,1035,294,55,1893,4605
2022,Cuba,-,825,1775,1139,32176,921,3304,40140,770,1865,1379,45929,882,5074,55899,401975
2022,"Cabo Verde",-,0,5,0,15,0,5,25,0,0,0,19,0,0,19,276
2022,Cyprus,-,0,0,0,7,0,0,7,0,0,0,6,0,0,6,31
2022,Czechia,-,6,21,16,99,137,0,279,5,31,10,142,201,10,399,832
2022,Denmark,-,0,0,0,0,0,0,0,0,5,0,0,0,0,5,35
2022,Djibouti,-,6,50,10,797,10,613,1486,6,26,25,227,0,510,794,3533
2022,Dominica,-,0,10,0,23,0,6,39,0,0,0,10,0,5,15,219
2022,"Dominican Rep.",-,14,52,45,1377,15,234,1737,24,42,46,2053,16,203,2384,7715
2022,Ecuador,-,707,1429,702,6800,30,1004,10672,726,1433,806,6347,55,1197,10564,68898
2022,"Equatorial Guinea",-,5,0,23,15,0,175,218,0,7,5,36,7,181,236,604
2022,Eritrea,-,14472,30253,25537,127972,8488,8861,215583,15013,31324,28030,133096,8959,18362,234784,601083
2022,Estonia,-,0,0,0,5,0,5,10,0,0,0,5,0,0,5,106
2022,Ethiopia,-,10590,14949,10874,62393,2682,2667,104155,11465,16145,11702,94508,3769,3617,141206,3602015
2022,"French Guiana",-,55,12,0,0,0,0,67,57,14,0,0,0,0,71,166
2022,Fiji,-,0,0,0,14,0,0,14,0,5,0,28,0,0,33,3653
2022,Finland,-,5,0,0,0,0,0,5,0,0,5,0,0,0,5,15
2022,France,-,11,19,10,19,0,5,64,17,22,0,32,6,20,97,470
2022,"Micronesia (Federated States of)",-,0,0,0,0,0,0,0,0,0,0,0,0,0,0,5
2022,Gabon,-,5,15,10,68,0,375,473,0,10,5,80,0,296,391,1489
2022,Gambia,-,132,69,34,611,5,525,1376,117,56,91,1805,11,2048,4128,15552
2022,Palestinian,-,548,1165,945,4951,882,38711,47202,609,1159,1007,6909,964,44581,55229,118158
2022,"United Kingdom of Great Britain and Northern Ireland",-,0,10,26,31,0,34,101,0,13,0,42,5,53,113,645
2022,Georgia,-,9694,18516,13783,82296,37203,7302,168794,10257,19567,14838,80047,22949,6389,154047,335411
2022,Germany,-,0,0,7,22,0,15,44,0,12,0,29,0,35,76,701
2022,Ghana,-,167,688,1408,3660,491,501,6915,118,717,1380,3857,280,1404,7756,23732
2022,Guinea-Bissau,-,15,0,10,60,0,541,626,11,6,27,245,0,951,1240,4328
2022,Greece,-,5,5,5,16,7,5,43,5,5,5,22,32,10,79,319
2022,Grenada,-,0,0,0,7,0,0,7,0,0,0,11,0,0,11,167
2022,Guatemala,-,23259,38887,35393,162026,18803,4046,282414,21942,38202,45935,189743,17733,2656,316211,736884
2022,Guinea,-,824,309,209,2518,28,15789,19677,772,272,729,5960,37,13843,21613,60486
2022,Guyana,-,18,14,11,117,0,2534,2694,20,13,16,113,0,1714,1876,5379
2022,Haiti,-,718,2188,1317,32917,369,3696,41205,674,2148,1261,45238,252,4279,53852,240175
2022,"China, Hong Kong SAR",-,0,11,10,60,0,0,81,0,8,24,60,0,0,92,1162
2022,Honduras,-,18968,37118,26376,125383,8492,8376,224713,20746,33538,26865,124141,7910,6709,219909,562808
2022,Croatia,-,0,0,15,108,32,41,196,0,0,0,96,96,30,222,17790
2022,Hungary,-,30,110,99,671,128,24,1062,29,103,111,707,172,80,1202,3280
2022,Iceland,-,0,0,0,0,0,0,0,0,0,0,8,0,0,8,13
2022,"Cote d'Ivoire",-,608,563,398,4328,112,10970,16979,512,505,454,5584,85,6755,13895,47302
2022,India,-,205,721,522,6825,222,985,9480,274,919,788,25655,406,12044,40086,121713
2022,Indonesia,-,22,57,31,1317,41,10,1478,18,51,27,379,6,5,486,22921
2022,Ireland,-,0,5,0,11,0,0,16,0,10,5,5,0,8,28,202
2022,"Iran (Islamic Rep. of)",-,1350,2634,2427,23777,2573,4576,37337,1346,2856,2754,32021,3277,7723,49977,192059
2022,Iraq,-,12610,28411,24119,94551,11850,10663,182204,13254,30253,26468,117431,10675,17245,215326,1713831
2022,Israel,-,5,30,10,77,10,75,207,11,18,17,147,8,200,401,1715
2022,Italy,-,5,22,47,54,5,30,163,8,24,34,67,5,41,179,821
2022,Jamaica,-,5,27,33,625,24,27,741,0,17,43,824,12,137,1033,5203
2022,Jordan,-,66,187,182,2042,61,254,2792,73,192,193,1781,46,550,2835,10510
2022,Japan,-,0,6,10,20,0,0,36,0,5,8,24,0,0,37,216
2022,Kazakhstan,-,19,69,38,526,65,801,1518,25,80,37,568,23,758,1491,11848
2022,Kenya,-,166,620,352,2399,206,195340,199083,181,657,392,1951,175,206384,209740,419165
2022,Kyrgyzstan,-,25,73,58,529,19,483,1187,38,71,72,690,13,460,1344,7709
2022,Kiribati,-,0,0,0,0,0,0,0,0,0,0,0,0,0,0,30
2022,"Rep. of Korea",-,0,0,0,104,0,10,114,0,5,0,45,0,0,50,1012
2022,"Dem. People's Rep. of Korea",-,0,0,10,67,10,14,101,0,0,5,49,11,19,84,394
2022,Kuwait,-,13,82,66,193,10,281,645,11,49,73,171,0,432,736,4884
2022,"Lao People's Dem. Rep.",-,0,0,0,7,16,2957,2980,0,0,0,49,21,3465,3535,7129
2022,Liberia,-,134,192,190,1215,70,314,2115,111,169,201,1445,85,614,2625,8590
2022,Libya,-,146,426,288,1082,41,1190,3173,178,477,316,2358,83,2545,5957,185528
2022,"Saint Lucia",-,0,10,0,33,0,5,48,0,0,0,38,0,5,43,216
2022,Lebanon,-,2085,2084,825,9972,949,606,16521,2234,2270,928,4413,303,1127,11275,35754
2022,Lesotho,-,7,0,0,10,0,0,17,6,0,0,0,0,0,6,42
2022,Liechtenstein,-,0,0,0,0,0,0,0,0,0,0,0,0,5,5,10
2022,"Sri Lanka",-,126,292,270,2108,561,42855,46212,137,296,256,5933,604,50687,57913,171859
2022,Lithuania,-,0,0,0,25,0,9,34,0,0,0,21,5,22,48,205
2022,Luxembourg,-,0,0,0,5,0,0,5,0,0,0,0,0,0,0,5
2022,Latvia,-,0,0,0,24,0,27,51,0,0,0,29,0,35,64,284
2022,"China, Macao SAR",-,0,0,0,0,0,0,0,0,0,5,0,0,0,5,58
2022,Madagascar,-,0,0,0,54,5,256,315,10,0,0,25,0,206,241,1079
2022,Mauritania,-,1266,2939,2550,6359,716,2697,16527,1320,3032,2330,6091,843,6320,19936,45486
2022,"North Macedonia",-,279,485,287,1289,75,610,3025,322,497,301,1295,104,614,3133,7052
2022,"Rep. of Moldova",-,171,259,204,1379,104,1167,3284,184,250,177,1561,76,1253,3501,11810
2022,Maldives,-,0,0,5,0,0,5,10,0,0,0,0,0,0,0,104
2022,Mexico,-,982,3580,2490,22958,383,1009,31402,1033,3757,2665,24475,508,1299,33737,406479
2022,Mali,-,15674,27132,17039,45805,3810,6051,115511,15436,26471,16466,35437,3633,11548,108991,618028
2022,Malaysia,-,0,10,10,73,0,18,111,0,5,0,70,0,14,89,21123
2022,Malawi,-,14,31,11,288,0,5,349,10,21,21,636,7,5,700,1668
2022,Mongolia,-,41,88,44,441,20,598,1232,42,68,61,494,21,502,1188,7359
2022,Morocco,-,113,122,46,811,33,3098,4223,142,130,107,1691,28,14633,16731,29925
2022,Mozambique,-,149,256,192,384,51,549976,551008,183,243,172,298,29,478803,479728,1037483
2022,Malta,-,0,0,0,0,0,0,0,0,0,0,0,0,0,0,10
2022,Montenegro,-,38,31,28,210,22,127,456,27,31,32,257,12,107,466,1567
2022,Mauritius,-,0,5,0,40,0,45,90,0,10,0,24,0,44,78,636
2022,Myanmar,-,119896,153608,100637,376916,30841,571227,1353125,125065,159343,108467,379937,33014,580476,1386302,2805488
2022,Namibia,-,6,13,18,80,0,0,117,7,12,12,33,0,0,64,1801
2022,Nepal,-,0,5,24,400,10,637,1076,5,18,27,1652,20,935,2657,20850
2022,"Netherlands (Kingdom of the)",-,6,6,15,40,0,0,67,10,15,0,20,0,0,45,196
2022,Niger,-,30943,66515,40945,97161,7854,192,243610,24785,57172,34204,66562,10872,532,194127,439110
2022,Nicaragua,-,2320,6969,4901,116410,14397,3962,148959,2365,5534,4801,101628,11664,5338,131330,359474
2022,Nigeria,-,27071,55088,29523,87562,6836,1810882,2016962,26255,53193,26935,65506,7892,1496153,1675934,3761416
2022,Niue,-,0,0,0,0,0,0,0,0,0,0,0,0,0,0,18
2022,Norway,-,0,0,0,0,0,0,0,0,0,0,5,0,0,5,20
2022,Nauru,-,0,0,0,0,0,0,0,0,0,0,0,0,0,0,24
2022,"New Zealand",-,0,0,0,0,0,0,0,0,0,0,9,0,0,9,80
2022,Oman,-,0,10,0,7,0,0,17,0,5,15,0,0,0,20,158
2022,Pakistan,-,9836,11678,7057,26990,2656,1797,60014,9033,12195,6495,32079,3005,24943,87750,1433855
2022,Panama,-,211,59,10,41,0,74,395,185,47,0,68,0,97,397,97957
2022,Paraguay,-,10,5,12,44,0,423,494,5,0,16,37,7,510,575,1341
2022,Peru,-,288,282,239,2064,144,7484,10501,264,318,209,2183,165,6901,10040,649301
2022,Philippines,-,0,36,10,419,45,50245,50755,7,17,11,247,41,48149,48472,287356
2022,Palau,-,0,0,0,5,0,0,5,0,0,0,0,0,0,0,5
2022,"Papua New Guinea",-,0,0,0,0,0,0,0,0,0,0,0,0,0,0,91854
2022,Poland,-,5,11,19,245,150,84,514,0,15,12,270,335,148,780,2015
2022,Portugal,-,6,14,10,41,0,31,102,0,14,0,35,0,16,65,503
2022,Qatar,-,0,0,0,0,0,0,0,0,5,0,5,0,0,10,168
2022,Romania,-,91,235,218,1099,35,998,2676,108,287,232,1302,77,1628,3634,10159
2022,"South Africa",-,31,126,108,511,30,111,917,37,102,119,367,35,125,785,4264
2022,"Russian Federation",-,976,2466,1718,10296,1237,23546,40239,983,2626,1969,11379,703,24421,42081,173611
2022,Rwanda,-,18299,31184,23921,58240,3866,2982,138492,19208,33031,23783,53620,5060,2916,137618,292037
2022,"El Salvador",-,1787,6284,4727,33656,360,95784,142598,1785,6810,5311,33686,444,82015,130051,417444
2022,"Saudi Arabia",-,5,44,43,237,0,53,382,5,34,56,319,0,50,464,4510
2022,"Serbia and Kosovo: S/RES/1244 (1999)",-,1217,1485,1520,6428,2078,9585,22313,1304,1524,1575,7513,1969,9926,23811,247685
2022,Senegal,-,228,358,349,1551,123,2345,4954,237,416,449,5770,169,4260,11301,30466
2022,Seychelles,-,0,0,0,0,0,0,0,0,0,0,0,0,0,0,14
2022,Singapore,-,0,0,10,0,0,0,10,0,0,5,5,0,0,10,150
2022,"Sierra Leone",-,129,200,207,1228,17,1123,2904,116,197,204,1942,35,1991,4485,13165
2022,"Solomon Islands",-,0,0,0,0,0,0,0,0,0,0,11,0,0,11,1604
2022,Somalia,-,430035,400627,229637,788392,28445,53209,1930345,452298,418438,232610,720671,28994,57460,1910471,3897242
2022,Spain,-,5,16,42,33,0,5,101,5,30,5,67,0,20,127,514
2022,"Viet Nam",-,102,183,149,1813,279,3987,6513,94,204,170,2059,402,4911,7840,28202
2022,"Saint Kitts and Nevis",-,0,0,0,5,0,0,5,0,0,5,5,0,0,10,54
2022,"Sao Tome and Principe",-,0,0,0,6,0,5,11,0,0,0,0,0,0,0,34
2022,Sudan,-,262525,474844,318252,900582,106335,10532,2073070,322732,586339,391870,918273,119651,29195,2368060,4478819
2022,Suriname,-,5,0,0,0,0,21,26,7,0,0,12,0,20,39,187
2022,"South Sudan",-,166221,290411,201125,489633,48477,227,1196094,169304,298334,224169,378842,32185,453,1103287,4146889
2022,Slovakia,-,13,29,33,152,24,69,320,16,40,27,199,42,61,385,782
2022,Slovenia,-,0,0,0,0,0,0,0,0,0,0,5,7,0,12,38
2022,Eswatini,-,6,0,0,51,0,0,57,0,5,16,46,0,0,67,261
2022,Sweden,-,0,11,0,15,0,0,26,5,5,0,5,0,5,20,105
2022,Switzerland,-,0,0,0,0,0,0,0,0,0,0,0,0,8,8,35
2022,"Syrian Arab Rep.",-,417801,582912,383059,1390896,106481,42584,2923733,442754,617138,420600,1699202,94954,88346,3362994,28710593
2022,"United Rep. of Tanzania",-,57,72,34,422,5,84,674,36,66,51,615,5,100,873,2737
2022,"Turks and Caicos Islands",-,5,0,0,11,0,0,16,0,0,0,0,0,0,0,30
2022,Thailand,-,0,5,10,117,0,30,162,0,0,18,52,10,11,91,3413
2022,Tajikistan,-,116,194,120,677,12,234,1353,126,204,142,1392,20,376,2260,6597
2022,Turkmenistan,-,5,22,13,163,6,215,424,10,14,27,437,6,607,1101,3103
2022,Timor-Leste,-,0,0,0,0,0,0,0,0,0,0,14,0,0,14,696
2022,Togo,-,80,262,268,1602,153,545,2910,72,242,289,2662,278,1121,4664,10760
2022,Tonga,-,0,0,5,0,0,0,5,0,0,0,0,0,0,0,1338
2022,"Trinidad and Tobago",-,358,43,14,73,5,15,508,355,48,5,78,0,25,511,7145
2022,Tunisia,-,50,67,49,455,9,1012,1642,74,68,65,1411,22,4878,6518,10653
2022,Türkiye,-,2326,3766,2340,16063,2107,8886,35488,2495,4306,2971,43248,2529,25091,80640,176453
2022,"United Arab Emirates",-,0,11,23,31,0,0,65,0,8,18,43,0,12,81,793
2022,Uganda,-,280,392,346,2935,58,1317171,1321182,276,379,337,4758,103,1265483,1271336,2601340
2022,Ukraine,-,267195,452035,429583,2598354,837457,1528576,6113200,241501,421284,389291,1595164,556643,781733,3985616,12177944
2022,Uruguay,-,54,0,0,54,0,82,190,76,7,6,36,0,75,200,660
2022,"United States of America",-,321,234,92,125,14,129,915,365,259,82,194,30,225,1155,3452
2022,Uzbekistan,-,76,111,126,706,53,529,1601,55,172,122,1554,23,990,2916,13067
2022,Vanuatu,-,0,7,6,9,0,0,22,0,5,0,0,0,0,5,710
2022,"Holy See",-,0,0,0,0,0,0,0,0,0,0,0,0,0,0,17
2022,"Saint Vincent and the Grenadines",-,0,5,0,53,5,0,63,0,0,0,37,0,0,37,256
2022,"Venezuela (Bolivarian Republic of)",-,216080,269570,377676,2164403,157743,621049,3806521,214783,264498,345377,1843934,132382,547510,3348484,9973118
2022,Samoa,-,0,0,0,0,0,0,0,0,0,0,0,0,0,0,403
2022,"Western Sahara",-,0,0,0,20,0,198,218,0,0,0,97,0,669,766,91776
2022,Yemen,-,1767,2936,2452,10960,888,2228707,2247710,1799,3131,2839,25633,1162,2299248,2333812,4596721
2022,Zambia,-,0,0,10,142,0,6,158,0,5,5,109,0,7,126,772
2022,Zimbabwe,-,97,228,320,3999,103,103,4850,82,215,252,4795,105,74,5523,14664
2022,Stateless,-,134448,117016,72909,425425,44139,303633,1097570,138828,134752,68648,342038,47364,295592,1027222,3190391
2022,Tibetan,-,0,0,0,0,0,6897,6897,0,0,0,5,0,5648,5653,12560
2022,Anguilla,-,0,0,0,0,0,5,5,0,0,0,0,0,0,0,10
2022,Aruba,-,0,0,0,0,0,901,901,0,0,0,0,0,799,799,1707
2022,Guadeloupe,-,5,6,0,21,0,0,32,0,7,0,9,0,0,16,145
2022,"Curacao ",-,0,0,0,0,0,901,901,0,0,0,0,0,799,799,1740
2022,"Unknown ",-,2166,2262,1813,9394,959,113453,130047,2205,2428,2108,16852,1168,117988,142749,613555
2023,Afghanistan,-,798613,1347973,887338,2250692,253486,247454,5785556,791053,1315301,774826,1996168,280970,358019,5516337,11540265
2023,Albania,-,169,537,700,2412,440,7206,11464,192,516,829,3013,447,6966,11963,39458
2023,Algeria,-,172,231,160,1061,120,2259,4003,185,208,271,5029,164,4044,9901,19007
2023,Andorra,-,0,0,0,0,0,0,0,0,0,0,0,0,0,0,14
2023,Angola,-,984,2025,1603,4962,514,3896,13984,986,1911,1569,4166,860,4190,13682,47967
2023,"Antigua and Barbuda",-,0,0,0,6,0,0,6,0,0,0,6,0,0,6,118
2023,Egypt,-,295,590,540,1849,182,1299,4755,222,619,610,4899,223,25644,32217,69789
2023,Argentina,-,44,28,5,157,0,933,1167,36,23,16,188,10,1086,1359,4693
2023,Armenia,-,190,413,271,2625,646,4488,8633,190,447,448,2911,457,4673,9126,33458
2023,Australia,-,0,0,0,6,0,0,6,5,0,0,9,0,5,19,97
2023,Austria,-,0,0,5,0,0,0,5,0,0,0,0,0,0,0,53
2023,Azerbaijan,-,17896,32499,33284,210686,45430,2834,342629,18925,36357,36974,204135,33335,3220,332946,822624
2023,Bahrain,-,14,5,15,65,6,19,124,11,12,19,104,6,11,163,511
2023,Barbados,-,0,0,0,7,0,0,7,0,0,5,5,0,0,10,553
2023,Burundi,-,31605,36761,24982,82109,4638,3357,183452,31794,36791,26108,103681,4728,4019,207121,395295
2023,Belgium,-,0,0,6,16,5,0,27,0,0,6,15,5,0,26,202
2023,Benin,-,54,58,23,244,0,341,720,56,31,91,693,5,959,1835,12506
2023,Bermuda,-,0,0,0,0,0,0,0,0,0,0,0,0,0,0,104
2023,Bangladesh,-,172,306,346,1489,238,2736,5287,144,280,463,12319,294,41067,54567,637976
2023,Bahamas,-,0,0,0,0,0,0,0,0,0,0,0,0,0,0,2892
2023,Bhutan,-,125,370,346,1776,352,40,3009,126,387,422,2021,528,134,3618,7144
2023,"Burkina Faso",-,44170,328640,228695,552601,7172,883,1162161,45715,333290,236877,409744,5965,6482,1038073,2207822
2023,Belarus,-,40,177,156,907,155,1166,2601,44,150,163,1077,123,1329,2886,26908
2023,"Bolivia (Plurinational State of)",-,15,33,28,188,5,176,445,13,28,41,173,21,167,443,4935
2023,Botswana,-,24,29,27,391,5,0,476,11,31,23,240,5,0,310,1567
2023,Brazil,-,2972,1199,56,740,10,899,5876,3001,1291,73,1141,5,913,6424,77470
2023,"Brunei Darussalam",-,0,0,0,0,0,0,0,0,0,0,0,0,0,0,24
2023,"Bosnia and Herzegovina",-,94,167,116,884,271,4251,5783,103,175,138,1325,205,4487,6433,111854
2023,Bulgaria,-,0,14,0,23,9,35,81,5,5,0,25,30,45,110,787
2023,Belize,-,0,12,15,28,0,0,55,13,12,12,33,0,0,70,1048
2023,Cambodia,-,19,27,24,266,6,5277,5619,18,23,30,204,15,5772,6062,12583
2023,Canada,-,9,0,17,33,0,28,87,9,5,10,72,5,27,128,534
2023,"Central African Rep.",-,41532,95988,66102,185713,14402,3370,407107,42085,96854,64431,145249,12413,3421,364453,1289167
2023,Chad,-,4000,4379,2864,9071,1168,1600,23082,3904,4283,2599,8925,1061,2690,23462,367517
2023,China,-,215,352,256,2426,272,7215,10736,187,383,345,3908,341,8972,14136,297761
2023,Chile,-,3124,1127,15,125,35,503,4929,3093,1128,11,170,65,568,5035,23936
2023,Cameroon,-,7593,14911,8850,31987,2827,3657,69825,7557,14521,8222,21516,1583,13884,67283,1250068
2023,Congo,-,134,253,392,3523,117,3396,7815,94,245,376,5051,204,3497,9467,24284
2023,"Dem. Rep. of the Congo",-,87088,111472,79207,242373,16873,21427,558440,88012,112254,79936,237398,14066,21562,553228,7398279
2023,Comoros,-,0,0,0,80,0,924,1004,5,0,16,350,0,1420,1791,3115
2023,Colombia,-,60392,240199,368310,2214916,464609,219274,3567700,59797,238545,368850,2206132,460887,217889,3552100,8753972
2023,"Costa Rica",-,123,171,156,946,356,74,1826,126,167,152,878,286,58,1667,5000
2023,Cuba,-,612,1631,1134,24524,1039,3597,32537,637,1598,1328,37924,1039,4865,47391,372815
2023,"Cabo Verde",-,0,0,5,0,0,14,19,0,0,0,5,0,0,5,266
2023,Cyprus,-,5,0,0,0,0,0,5,0,0,0,0,0,0,0,43
2023,Czechia,-,0,5,0,22,127,0,154,0,0,0,41,191,5,237,813
2023,Denmark,-,0,0,0,0,0,0,0,0,0,0,0,0,0,0,16
2023,Djibouti,-,10,30,16,94,5,785,940,19,21,34,119,0,666,859,3414
2023,Dominica,-,0,0,5,19,0,7,31,0,0,10,22,0,11,43,417
2023,"Dominican Rep.",-,20,38,36,1375,19,402,1890,26,31,57,1868,13,285,2280,11677
2023,Ecuador,-,280,322,997,3623,16,737,5975,315,338,1271,5161,16,894,7995,96352
2023,"Equatorial Guinea",-,5,0,17,35,0,190,247,5,5,5,19,9,200,243,846
2023,Eritrea,-,18655,38909,32152,166175,11782,23740,291413,19062,40037,35594,194678,12851,34391,336613,673215
2023,Estonia,-,0,0,0,5,0,5,10,0,0,0,5,0,0,5,118
2023,Ethiopia,-,254129,329504,156096,618198,76353,3315,1437595,225009,317060,159775,596464,94432,4528,1397268,3979257
2023,"French Guiana",-,114,44,0,0,0,0,158,112,48,0,0,0,0,160,424
2023,Fiji,-,0,0,0,0,0,0,0,0,0,0,0,0,0,0,3224
2023,Finland,-,0,0,7,0,0,0,7,0,0,0,0,0,0,0,46
2023,France,-,5,10,0,5,0,0,20,9,0,0,0,7,6,22,525
2023,Gabon,-,0,19,0,48,0,430,497,10,5,0,42,0,345,402,1709
2023,Gambia,-,188,215,125,956,56,625,2165,142,172,263,2168,61,2868,5674,13856
2023,Palestinian,-,1390,2178,1587,8444,892,4395,18886,1286,2429,2092,12861,930,11472,31070,56330
2023,"United Kingdom of Great Britain and Northern Ireland",-,10,13,6,21,0,14,64,0,9,5,46,5,28,93,604
2023,Georgia,-,9103,18705,14691,82991,38282,8738,172510,9815,19558,15891,80288,23715,6845,156112,349082
2023,Germany,-,0,0,0,13,0,5,18,0,0,0,11,0,0,11,971
2023,Ghana,-,114,517,1496,3866,617,463,7073,104,513,1465,3801,334,1162,7379,24961
2023,Guinea-Bissau,-,15,11,15,179,0,584,804,10,6,30,286,5,1038,1375,3240
2023,Greece,-,0,0,0,12,6,0,18,0,10,5,21,29,0,65,321
2023,Grenada,-,0,0,6,12,5,0,23,0,0,6,14,5,0,25,193
2023,Guatemala,-,30251,47789,29950,140886,21171,514,270561,28522,45106,28279,135473,20033,580,257993,738071
2023,Guinea,-,1103,744,287,3687,55,18616,24492,1004,556,1145,7258,54,17236,27253,73103
2023,Guyana,-,31,16,6,73,0,14,140,38,23,10,74,0,30,175,1513
2023,Haiti,-,27752,23353,29384,82645,12958,43345,219437,34860,29471,36204,117307,16024,53376,287242,701492
2023,"China, Hong Kong SAR",-,0,0,9,21,5,0,35,0,0,10,34,5,0,49,1033
2023,Honduras,-,18421,34478,25137,114623,9897,4670,207226,20169,30417,24711,117474,9138,4588,206497,599277
2023,Croatia,-,0,5,10,99,31,41,186,0,6,6,140,82,44,278,17676
2023,Hungary,-,9,0,14,32,59,28,142,0,6,0,35,124,69,234,3396
2023,Iceland,-,0,0,0,0,0,0,0,0,0,0,0,0,0,0,5
2023,"Cote d'Ivoire",-,588,538,312,3356,72,15891,20757,534,415,439,4237,71,9448,15144,51969
2023,India,-,54,138,186,1055,177,726,2336,32,137,230,4322,208,3442,8371,168166
2023,Indonesia,-,56,132,138,1235,50,35,1646,46,153,148,425,57,21,850,26057
2023,Ireland,-,0,0,0,0,0,0,0,0,0,0,0,0,0,0,219
2023,"Iran (Islamic Rep. of)",-,2496,5967,6095,35056,4782,5683,60079,2217,5791,7529,57783,5743,8735,87798,215795
2023,Iraq,-,10087,22641,19944,86300,11191,11429,161592,10084,24152,22890,119940,10284,16963,204313,1646929
2023,Israel,-,6,27,28,112,36,67,276,18,34,36,185,26,131,430,2087
2023,Italy,-,10,23,13,16,0,7,69,0,14,5,24,0,7,50,1611
2023,Jamaica,-,0,29,49,341,24,43,486,10,20,60,586,24,192,892,9192
2023,Jordan,-,79,177,156,1802,80,259,2553,74,172,148,1389,44,473,2300,13452
2023,Japan,-,0,0,9,7,0,0,16,0,0,10,10,0,0,20,192
2023,Kazakhstan,-,31,68,52,363,59,787,1360,20,81,74,416,21,782,1394,15072
2023,Kenya,-,87,637,427,2017,217,195378,198763,58,710,465,1738,200,206470,209641,425311
2023,Kyrgyzstan,-,32,61,57,271,26,503,950,34,69,68,313,14,424,922,11365
2023,Kiribati,-,0,0,0,0,0,0,0,0,0,0,0,0,0,0,27
2023,"Rep. of Korea",-,0,0,0,27,5,0,32,0,0,10,25,0,0,35,1046
2023,"Dem. People's Rep. of Korea",-,0,5,5,51,10,9,80,0,0,5,64,13,24,106,335
2023,Kuwait,-,54,187,212,617,102,288,1460,35,162,266,619,79,464,1625,4744
2023,"Lao People's Dem. Rep.",-,0,0,5,0,6,2947,2958,0,0,0,25,16,3486,3527,7111
2023,Liberia,-,133,173,198,1255,74,240,2073,133,167,204,1518,92,530,2644,8942
2023,Libya,-,204,743,787,2478,439,1338,5989,211,691,970,4515,493,2741,9621,149842
2023,"Saint Lucia",-,0,0,6,8,5,20,39,0,0,8,14,5,13,40,348
2023,Lebanon,-,2719,3007,1029,11070,1073,598,19496,2820,3166,1149,5528,326,927,13916,41100
2023,Lesotho,-,0,0,0,15,0,0,15,6,0,0,10,0,0,16,59
2023,"Sri Lanka",-,162,462,551,2643,708,44833,49359,156,422,645,5694,827,53906,61650,168224
2023,Lithuania,-,0,0,0,8,0,0,8,0,0,0,10,0,5,15,185
2023,Luxembourg,-,0,0,0,5,0,0,5,0,0,0,0,0,0,0,5
2023,Latvia,-,0,0,0,5,0,17,22,0,0,0,19,0,21,40,314
2023,"China, Macao SAR",-,0,0,0,0,0,0,0,0,0,0,5,0,0,5,21
2023,Madagascar,-,5,5,0,40,5,356,411,12,0,0,10,0,264,286,860
2023,Martinique,-,0,0,0,0,0,0,0,0,0,0,0,0,0,0,5
2023,Mauritania,-,730,2899,2595,6775,801,3018,16818,712,3037,2391,6389,915,6844,20288,56304
2023,"North Macedonia",-,248,459,256,1178,61,674,2876,281,460,320,1152,92,677,2982,6632
2023,"Rep. of Moldova",-,126,158,135,1096,133,1119,2767,126,190,161,1294,83,1144,2998,11758
2023,Maldives,-,0,0,10,7,5,6,28,0,0,5,13,5,0,23,97
2023,Mexico,-,5,10039,14840,95608,16125,237,136854,5,10483,15352,84289,16017,245,126391,440594
2023,"Marshall Islands",-,0,0,0,0,0,0,0,0,0,0,0,0,0,0,5
2023,Mali,-,14531,28386,19372,52010,4661,208910,327870,14323,27428,18844,41144,4334,167867,273940,617912
2023,Malaysia,-,5,22,34,137,39,16,253,0,18,50,194,29,17,308,19809
2023,Malawi,-,10,39,37,292,23,0,401,10,20,51,766,28,7,882,2187
2023,Mongolia,-,48,96,80,324,30,607,1185,55,92,88,437,20,537,1229,8725
2023,Morocco,-,160,247,209,1330,189,3052,5187,182,260,314,2950,168,11593,15467,27035
2023,Mozambique,-,57240,52864,43602,140573,28766,18,323063,48616,55399,39243,101903,16562,10,261733,591649
2023,Malta,-,0,0,0,0,0,0,0,0,0,0,0,0,0,0,6
2023,Montenegro,-,21,29,26,169,23,131,399,31,37,28,151,16,117,380,1689
2023,Mauritius,-,9,5,7,53,6,54,134,0,18,7,60,6,61,152,794
2023,Myanmar,-,190743,299926,266371,1059052,151604,183,1967879,194722,331083,270903,991057,105104,472,1893341,3946291
2023,Namibia,-,0,31,40,157,25,0,253,8,20,45,155,25,5,258,2095
2023,Nepal,-,0,32,37,178,31,784,1062,5,29,51,396,30,608,1119,24791
2023,"Netherlands (Kingdom of the)",-,6,8,0,7,0,0,21,7,10,0,15,0,0,32,266
2023,Niger,-,27348,59834,37050,86811,7866,5895,224804,24705,53270,31351,72855,7454,4937,194572,421003
2023,Nicaragua,-,864,3396,4099,85672,12203,4026,110260,1136,3489,5051,75409,10043,4545,99673,338110
2023,Nigeria,-,25678,54415,32352,85778,6542,8245,213010,25226,51843,29152,60572,7648,7680,182121,3792770
2023,Niue,-,0,0,0,0,0,0,0,0,0,0,0,0,0,0,11
2023,Norway,-,5,0,0,0,0,0,5,0,0,0,5,0,0,5,36
2023,Nauru,-,0,0,0,0,0,0,0,0,0,0,0,0,0,0,23
2023,"New Zealand",-,0,0,0,0,0,0,0,0,0,0,9,0,0,9,67
2023,Oman,-,0,0,6,12,5,5,28,0,5,6,23,5,0,39,177
2023,Pakistan,-,4653,6186,4424,16610,2165,1899,35937,4344,6193,4730,27485,2434,31416,76602,1566748
2023,Panama,-,88,48,0,45,0,133,314,89,58,0,69,6,166,388,16645
2023,Paraguay,-,6,5,5,36,0,726,778,0,0,0,36,0,995,1031,2142
2023,Peru,-,147,60,42,690,108,25704,26751,130,67,41,747,127,23328,24440,102724
2023,Philippines,-,0,27,32,204,14,55341,55618,10,23,29,81,9,53120,53272,294795
2023,Palau,-,0,0,0,5,0,0,5,0,0,0,0,0,0,0,5
2023,"Papua New Guinea",-,76,179,131,478,69,0,933,84,172,149,448,84,0,937,98041
2023,Poland,-,0,7,10,34,146,61,258,5,0,10,67,323,110,515,1982
2023,Portugal,-,0,0,19,6,0,0,25,0,0,0,10,0,0,10,1024
2023,"Puerto Rico",-,0,0,0,5,0,0,5,0,0,0,0,0,0,0,5
2023,Qatar,-,0,0,5,9,0,5,19,0,0,5,16,0,0,21,116
2023,Romania,-,0,17,5,78,24,93,217,0,5,14,113,60,117,309,9208
2023,"South Africa",-,24,81,107,481,27,116,836,50,85,112,364,33,135,779,5088
2023,"Russian Federation",-,1266,2813,2243,11855,1737,23544,43458,1333,3168,2574,14333,1055,24955,47418,202057
2023,Rwanda,-,18228,28983,24008,59151,4435,3174,137979,18650,30626,24146,53554,5658,3123,135757,292747
2023,"El Salvador",-,657,2107,1601,11872,536,258581,275354,629,2165,1804,16436,586,285098,306718,751639
2023,"Saudi Arabia",-,5,56,93,290,36,75,555,0,39,100,365,36,49,589,3757
2023,"Serbia and Kosovo: S/RES/1244 (1999)",-,1233,1493,1498,6286,2093,9957,22560,1293,1543,1539,7411,1981,10169,23936,245391
2023,Senegal,-,214,406,374,1675,131,3002,5802,231,437,499,5393,177,5922,12659,30704
2023,Seychelles,-,0,0,0,5,0,0,5,0,0,0,5,0,5,10,23
2023,Singapore,-,0,0,5,0,0,0,5,0,0,5,10,0,0,15,266
2023,"Sierra Leone",-,207,354,287,1793,60,1379,4080,183,326,378,2716,75,2370,6048,15619
2023,"Solomon Islands",-,0,0,0,7,0,0,7,0,0,0,6,0,0,6,1556
2023,Somalia,-,585783,515922,390039,823953,93653,44327,2453677,532293,554715,419308,741033,126122,49798,2423269,4945699
2023,Spain,-,9,8,10,18,0,5,50,0,8,0,37,0,10,55,1378
2023,"Viet Nam",-,134,348,487,2727,591,3821,8108,120,305,601,3483,766,5064,10339,31586
2023,"Saint Kitts and Nevis",-,0,0,0,0,0,0,0,0,0,6,0,0,0,6,80
2023,"Sao Tome and Principe",-,6,0,0,6,0,5,17,0,0,0,0,0,0,0,35
2023,Sudan,-,590150,1117338,738046,2114035,260086,4809,4824464,740499,1397984,923577,2194630,294291,26592,5577573,10827289
2023,Suriname,-,11,5,0,0,0,35,51,6,5,0,7,0,22,40,226
2023,"South Sudan",-,142636,298873,213793,504310,44486,495,1204593,144835,306531,237755,388740,25470,640,1103971,4008647
2023,Slovakia,-,0,0,0,5,17,67,89,0,0,5,20,35,63,123,741
2023,Slovenia,-,0,0,0,0,0,0,0,0,0,0,0,7,0,7,98
2023,Eswatini,-,7,12,16,104,5,0,144,5,10,21,87,5,5,133,391
2023,Sweden,-,5,5,5,7,0,0,22,0,8,6,0,0,0,14,203
2023,Switzerland,-,0,0,0,0,0,0,0,0,0,0,0,0,0,0,42
2023,"Syrian Arab Rep.",-,401858,595833,389818,1438233,114723,54808,2995273,424336,628681,430668,1789558,103240,100307,3476790,29835017
2023,"United Rep. of Tanzania",-,48,76,71,322,16,114,647,44,90,79,620,22,127,982,3899
2023,"Turks and Caicos Islands",-,5,0,0,6,0,0,11,0,0,0,0,0,0,0,25
2023,Thailand,-,0,0,11,71,10,37,129,0,0,15,70,11,19,115,3593
2023,Tajikistan,-,209,360,262,947,35,204,2017,201,362,250,1688,46,272,2819,9721
2023,Turkmenistan,-,10,44,34,245,13,53,399,10,35,41,627,10,82,805,3681
2023,Timor-Leste,-,0,0,0,0,0,0,0,0,0,0,13,0,10,23,1085
2023,Togo,-,525,819,508,3126,288,793,6059,551,742,521,3245,367,1492,6918,25827
2023,Tonga,-,0,0,0,5,0,0,5,0,0,0,0,0,0,0,1368
2023,"Trinidad and Tobago",-,443,93,19,55,11,5,626,458,75,26,113,10,22,704,7643
2023,Tunisia,-,65,99,76,553,23,1592,2408,101,121,105,2292,36,3909,6564,12004
2023,Türkiye,-,5209,9361,5828,32467,2771,15974,71610,5513,10279,7740,79276,3481,38876,145165,281347
2023,Tuvalu,-,0,0,0,0,0,0,0,0,0,0,0,0,0,0,5
2023,"United Arab Emirates",-,0,8,5,20,5,7,45,5,0,12,31,5,5,58,400
2023,Uganda,-,282,544,478,2943,155,1356807,1361209,290,487,530,4864,219,1303604,1309994,2682770
2023,Ukraine,-,145828,246827,299852,1778707,627190,337238,3435642,119123,268590,347421,1337024,354034,206734,2632926,10671775
2023,Uruguay,-,22,5,7,27,0,139,200,21,5,0,20,0,131,177,911
2023,"United States of America",-,34,73,78,183,26,125,519,26,68,94,316,55,187,746,3285
2023,Uzbekistan,-,49,95,87,586,59,380,1256,30,94,80,954,41,649,1848,21904
2023,Vanuatu,-,0,0,5,0,0,0,5,0,0,0,0,0,0,0,730
2023,"Saint Vincent and the Grenadines",-,0,5,11,11,5,0,32,0,0,8,21,5,0,34,322
2023,"Venezuela (Bolivarian Republic of)",-,208760,215981,629480,2647257,88823,821587,4611888,211931,217494,595898,2317366,54652,748576,4145917,10596489
2023,Samoa,-,0,0,0,0,0,0,0,0,0,0,0,0,0,0,391
2023,"Western Sahara",-,0,0,0,15,0,203,218,0,0,0,84,0,714,798,91801
2023,Yemen,-,2227,3655,3068,14113,1193,2232852,2257108,2232,3825,3753,34242,1552,2288695,2334299,4597930
2023,Zambia,-,0,5,18,148,11,10,192,0,10,8,142,6,5,171,957
2023,Zimbabwe,-,90,301,428,4164,165,106,5254,90,253,370,5289,181,78,6261,16755
2023,Stateless,-,156121,151582,110545,574530,71129,58207,1122114,160577,173948,107069,482931,64634,60523,1049682,3096778
2023,Tibetan,-,0,0,0,5,0,6907,6912,0,0,0,9,0,5668,5677,12589
2023,Anguilla,-,0,0,0,0,0,0,0,0,0,0,0,0,0,0,5
2023,Guadeloupe,-,5,0,0,0,0,0,5,0,0,0,0,0,0,0,97
2023,"Curacao ",-,0,0,0,0,0,0,0,0,0,0,0,0,0,0,8
2023,"Unknown ",-,6574,9094,6936,43600,12025,74807,153036,6727,9566,7907,54954,10285,83287,172726,629297
